variant	af_tot	af_xx	af_xy	ac_tot	ac_xx	ac_xy	an_tot	an_xx	an_xy	hom_tot	hom_xx	hom_xy	quality
CPX_21_5154	0.000046	9.21914E-05	0	1	1	0	21694	10847	10847	0	0	0	935
INV_21_823	0.000046	0	9.21914E-05	1	0	1	21694	10847	10847	0	0	0	935
DUP_21_49984	0.000046	0	9.21914E-05	1	0	1	21694	10847	10847	0	0	0	935
INS_21_113006	0.000046	0	9.21914E-05	1	0	1	21694	10847	10847	0	0	0	935
DEL_21_179620	0.000046	9.21914E-05	0	1	1	0	21694	10847	10847	0	0	0	935
DEL_21_179621	0.000046	9.21914E-05	0	1	1	0	21694	10847	10847	0	0	0	935
DEL_21_179622	0.000969	0.001199262	0.000738007	21	13	8	21680	10840	10840	0	0	0	935
INS_21_113007	0.000092	9.21914E-05	9.21914E-05	2	1	1	21694	10847	10847	0	0	0	935
INS_21_113008	0.000046	0	9.21914E-05	1	0	1	21694	10847	10847	0	0	0	935
DEL_21_179623	0.000046	0	9.21914E-05	1	0	1	21694	10847	10847	0	0	0	935
INS_21_113009	0.000046	9.21914E-05	0	1	1	0	21694	10847	10847	0	0	0	935
INS_21_113010	0.000138	0.000184383	9.21914E-05	3	2	1	21694	10847	10847	0	0	0	935
CTX_12_10	0.0000461	9.21914E-05	0	1	1	0	21694	10847	10847	0	0	0	999
21-27090533-G-A	3.18654E-05	8.76578E-05	0	1	1	0	31382	11408	19974	0	0	0	424
21-27090535-A-AG	3.18756E-05	0	5.00751E-05	1	0	1	31372	11402	19970	0	0	0	41
21-27090538-G-C	0.00159327	0.000175377	0.002402643	50	2	48	31382	11404	19978	0	0	0	228
21-27090539-G-T	3.18634E-05	0	5.00601E-05	1	0	1	31384	11408	19976	0	0	0	336
21-27090542-T-A	0.005262486	0.014313312	0.00010017	165	163	2	31354	11388	19966	2	2	0	448
21-27090550-C-G	6.37024E-05	8.76424E-05	5.0035E-05	2	1	1	31396	11410	19986	0	0	0	107
21-27090581-C-G	0.000668832	0.001839846	0	21	21	0	31398	11414	19984	0	0	0	385
21-27090583-A-T	3.1839E-05	0	5.001E-05	1	0	1	31408	11412	19996	0	0	0	26
21-27090586-G-A	0.000222973	0	0.000350315	7	0	7	31394	11412	19982	0	0	0	36
21-27090586-G-C	3.18532E-05	0	5.0045E-05	1	0	1	31394	11412	19982	0	0	0	290
21-27090593-C-T	3.1839E-05	8.75964E-05	0	1	1	0	31408	11416	19992	0	0	0	283
21-27090599-C-T	0.001178269	0.000350508	0.001650825	37	4	33	31402	11412	19990	0	0	0	206
21-27090610-A-C	9.55597E-05	0.000262881	0	3	3	0	31394	11412	19982	0	0	0	204
21-27090623-C-G	3.18573E-05	8.76578E-05	0	1	1	0	31390	11408	19982	0	0	0	451
21-27090697-G-A	3.19836E-05	8.78889E-05	0	1	1	0	31266	11378	19888	0	0	0	420
21-27090704-C-T	0.002708559	0.007450912	0	85	85	0	31382	11408	19974	1	1	0	431
21-27090705-G-A	0.000287118	8.77501E-05	0.000401003	9	1	8	31346	11396	19950	0	0	0	388
21-27090708-C-G	3.18613E-05	8.76578E-05	0	1	1	0	31386	11408	19978	0	0	0	344
21-27090713-G-A	0.000191327	0	0.000300601	6	0	6	31360	11400	19960	0	0	0	495
21-27090733-C-T	3.18471E-05	8.76271E-05	0	1	1	0	31400	11412	19988	0	0	0	108
21-27090735-C-T	0.008759636	0.023934771	0.00010006	275	273	2	31394	11406	19988	3	3	0	150
21-27090736-G-A	6.37511E-05	8.76732E-05	5.00851E-05	2	1	1	31372	11406	19966	0	0	0	298
21-27090748-T-C	3.18634E-05	0	5.00601E-05	1	0	1	31384	11408	19976	0	0	0	206
21-27090756-T-C	3.18471E-05	0	5.002E-05	1	0	1	31400	11408	19992	0	0	0	89
21-27090778-T-A	3.1841E-05	8.76271E-05	0	1	1	0	31406	11412	19994	0	0	0	324
21-27090811-C-T	3.18695E-05	0	5.00701E-05	1	0	1	31378	11406	19972	0	0	0	186
21-27090812-G-A	0.000127462	0.000350816	0	4	4	0	31382	11402	19980	0	0	0	254
21-27090814-G-A	0.992193474	0.978691687	0.9998999	31139	11161	19978	31384	11404	19980	15448	5460	9988	84
21-27090853-G-C	0.033065493	0.089815628	0.000700981	1037	1023	14	31362	11390	19972	70	70	0	30
21-27090887-G-A	6.37633E-05	0.000175408	0	2	2	0	31366	11402	19964	0	0	0	221
21-27090895-G-C	0.003378163	0.009210526	5.00551E-05	106	105	1	31378	11400	19978	0	0	0	283
21-27090896-A-C	6.37796E-05	0.0001755	0	2	2	0	31358	11396	19962	0	0	0	120
21-27090898-C-T	3.18756E-05	8.77193E-05	0	1	1	0	31372	11400	19972	0	0	0	454
21-27090901-G-T	3.18796E-05	0	5.00851E-05	1	0	1	31368	11402	19966	0	0	0	310
21-27090913-C-A	6.37105E-05	0.000175254	0	2	2	0	31392	11412	19980	0	0	0	71
21-27090916-C-T	0.000127437	8.76578E-05	0.00015015	4	1	3	31388	11408	19980	0	0	0	269
21-27090924-CA-C	6.37064E-05	0.000175285	0	2	2	0	31394	11410	19984	0	0	0	14
21-27090942-G-A	3.18471E-05	0	5.0035E-05	1	0	1	31400	11414	19986	0	0	0	102
21-27090945-G-A	0.000350452	0.000964405	0	11	11	0	31388	11406	19982	0	0	0	373
21-27090957-G-GCCCAGCCGAGCT	3.18613E-05	0	5.00501E-05	1	0	1	31386	11406	19980	0	0	0	497
21-27090965-G-A	0.00357029	0.009736842	5.00751E-05	112	111	1	31370	11400	19970	0	0	0	371
21-27090991-C-T	0.000159205	0.000350508	5.0015E-05	5	4	1	31406	11412	19994	0	0	0	442
21-27091025-T-TATC	3.18451E-05	8.76578E-05	0	1	1	0	31402	11408	19994	0	0	0	439
21-27091043-G-A	3.18634E-05	0	5.00501E-05	1	0	1	31384	11404	19980	0	0	0	298
21-27091065-AC-A	6.37024E-05	8.76271E-05	5.004E-05	2	1	1	31396	11412	19984	0	0	0	56
21-27091066-C-A	0.067099981	0.027344435	0.089807769	2106	312	1794	31386	11410	19976	87	7	80	34
21-27091067-A-AAAAT	3.18552E-05	0	5.0045E-05	1	0	1	31392	11410	19982	0	0	0	370
21-27091084-T-C	0.013154542	0.004995618	0.017812469	413	57	356	31396	11410	19986	7	0	7	70
21-27091087-C-T	3.18878E-05	8.77347E-05	0	1	1	0	31360	11398	19962	0	0	0	87
21-27091095-T-C	3.18573E-05	8.76885E-05	0	1	1	0	31390	11404	19986	0	0	0	270
21-27091096-A-T	3.18776E-05	0	5.00701E-05	1	0	1	31370	11398	19972	0	0	0	409
21-27091108-A-G	0.012550968	0.034029118	0.00030015	394	388	6	31392	11402	19990	10	10	0	421
21-27091121-C-T	0.000254874	0.000701754	0	8	8	0	31388	11400	19988	0	0	0	74
21-27091123-A-G	0.086128827	0.234968354	0.001401121	2701	2673	28	31360	11376	19984	421	420	1	394
21-27091136-C-T	0.005384566	0.014388489	0.00025015	169	164	5	31386	11398	19988	2	2	0	80
21-27091143-CCT-C	9.5584E-05	8.77347E-05	0.00010006	3	1	2	31386	11398	19988	0	0	0	432
21-27091156-G-A	3.18878E-05	0	5.00751E-05	1	0	1	31360	11390	19970	0	0	0	81
21-27091212-A-C	9.56023E-05	0.00026325	0	3	3	0	31380	11396	19984	0	0	0	326
21-27091213-T-C	0.000127421	0	0.00020008	4	0	4	31392	11400	19992	0	0	0	194
21-27091214-G-A	0.005226259	0.013949816	0.000250225	164	159	5	31380	11398	19982	0	0	0	145
21-27091227-A-G	6.37105E-05	8.76578E-05	5.004E-05	2	1	1	31392	11408	19984	0	0	0	219
21-27091243-C-G	3.18492E-05	8.77039E-05	0	1	1	0	31398	11402	19996	0	0	0	42
21-27091263-C-T	0.000223015	8.77347E-05	0.00030015	7	1	6	31388	11398	19990	0	0	0	410
21-27091283-AT-A	0.00121104	0.003333918	0	38	38	0	31378	11398	19980	0	0	0	412
21-27091288-C-G	3.18532E-05	0	5.002E-05	1	0	1	31394	11402	19992	0	0	0	346
21-27091290-G-A	0.000159307	0	0.0002502	5	0	5	31386	11402	19984	0	0	0	298
21-27091310-T-C	3.18451E-05	0	5.001E-05	1	0	1	31402	11406	19996	0	0	0	16
21-27091315-G-A	6.37552E-05	8.77193E-05	5.00751E-05	2	1	1	31370	11400	19970	0	0	0	490
21-27091350-G-C	3.18918E-05	8.78117E-05	0	1	1	0	31356	11388	19968	0	0	0	262
21-27091380-C-T	9.56084E-05	0.000263481	0	3	3	0	31378	11386	19992	0	0	0	195
21-27091389-C-T	3.18756E-05	0	5.0045E-05	1	0	1	31372	11390	19982	0	0	0	328
21-27091390-CA-C	3.18715E-05	8.77501E-05	0	1	1	0	31376	11396	19980	0	0	0	227
21-27091403-C-A	3.23499E-05	0	5.04796E-05	1	0	1	30912	11102	19810	0	0	0	397
21-27091410-G-A	3.56125E-05	0	5.45554E-05	1	0	1	28080	9750	18330	0	0	0	75
21-27091412-CACA-C	0.000117527	0.00034827	0	3	3	0	25526	8614	16912	0	0	0	79
21-27091427-T-G	0.023809524	0	0.029411765	1	0	1	42	8	34	0	0	0	365
21-27091427-TC-T	0.023809524	0	0.029411765	1	0	1	42	8	34	0	0	0	162
21-27091433-T-TC	1	1	1	31376	11388	19988	31376	11388	19988	15688	5694	9994	458
21-27091438-G-A	3.19898E-05	8.81523E-05	0	1	1	0	31260	11344	19916	0	0	0	34
21-27091465-C-A	3.18796E-05	0	5.0035E-05	1	0	1	31368	11382	19986	0	0	0	461
21-27091465-C-G	6.37592E-05	0.000175716	0	2	2	0	31368	11382	19986	0	0	0	101
21-27091470-C-A	3.18715E-05	8.77501E-05	0	1	1	0	31376	11396	19980	0	0	0	436
21-27091490-C-T	0.000159388	0.000438904	0	5	5	0	31370	11392	19978	0	0	0	176
21-27091508-T-C	3.18715E-05	0	5.00551E-05	1	0	1	31376	11398	19978	0	0	0	353
21-27091513-A-G	3.21151E-05	0	5.03474E-05	1	0	1	31138	11276	19862	0	0	0	214
21-27091543-T-G	3.18878E-05	8.77655E-05	0	1	1	0	31360	11394	19966	0	0	0	255
21-27091558-A-G	3.1957E-05	0	5.01807E-05	1	0	1	31292	11364	19928	0	0	0	118
21-27091558-AC-A	3.1957E-05	8.79972E-05	0	1	1	0	31292	11364	19928	0	0	0	302
21-27091609-C-G	9.55536E-05	0	0.000150105	3	0	3	31396	11410	19986	0	0	0	483
21-27091622-C-T	6.37024E-05	0.000175346	0	2	2	0	31396	11406	19990	0	0	0	427
21-27091644-G-T	3.18532E-05	0	5.0025E-05	1	0	1	31394	11404	19990	0	0	0	227
21-27091648-A-G	0.002484393	0.006750833	5.0025E-05	78	77	1	31396	11406	19990	0	0	0	304
21-27091654-T-G	9.55414E-05	0	0.000150075	3	0	3	31400	11410	19990	0	0	0	406
21-27091660-A-G	3.18512E-05	8.76424E-05	0	1	1	0	31396	11410	19986	0	0	0	367
21-27091670-C-G	3.18451E-05	0	5.0025E-05	1	0	1	31402	11412	19990	0	0	0	143
21-27091712-T-C	3.18431E-05	0	5.0015E-05	1	0	1	31404	11410	19994	0	0	0	489
21-27091713-G-A	3.18634E-05	0	5.00551E-05	1	0	1	31384	11406	19978	0	0	0	475
21-27091718-T-C	6.36821E-05	0	0.00010003	2	0	2	31406	11412	19994	0	0	0	319
21-27091728-A-G	3.18756E-05	8.77347E-05	0	1	1	0	31372	11398	19974	0	0	0	59
21-27091747-A-G	9.55718E-05	0.000263066	0	3	3	0	31390	11404	19986	0	0	0	203
21-27091757-C-T	0.000222916	0	0.00035014	7	0	7	31402	11410	19992	0	0	0	220
21-27091759-A-G	0.000222887	0.000525855	5.001E-05	7	6	1	31406	11410	19996	0	0	0	194
21-27091772-C-T	6.36943E-05	0.000175316	0	2	2	0	31400	11408	19992	0	0	0	302
21-27091775-C-T	0.004712775	0.002103418	0.006201861	148	24	124	31404	11410	19994	2	0	2	167
21-27091776-T-G	6.36983E-05	0	0.00010007	2	0	2	31398	11412	19986	0	0	0	267
21-27091803-A-G	3.18654E-05	8.77501E-05	0	1	1	0	31382	11396	19986	0	0	0	66
21-27091804-C-T	3.1841E-05	8.76424E-05	0	1	1	0	31406	11410	19996	0	0	0	125
21-27091812-TTCTA-T	0.000286624	0.000350693	0.000250075	9	4	5	31400	11406	19994	0	0	0	145
21-27091821-C-T	6.37105E-05	8.76732E-05	5.0035E-05	2	1	1	31392	11406	19986	0	0	0	477
21-27091829-G-A	3.18613E-05	0	5.00551E-05	1	0	1	31386	11408	19978	0	0	0	364
21-27091835-G-T	6.37227E-05	0	0.00010009	2	0	2	31386	11404	19982	0	0	0	98
21-27091856-G-A	3.18552E-05	8.76578E-05	0	1	1	0	31392	11408	19984	0	0	0	438
21-27091860-A-C	3.18512E-05	0	5.0025E-05	1	0	1	31396	11406	19990	0	0	0	47
21-27091896-T-C	6.37024E-05	0	0.00010005	2	0	2	31396	11406	19990	0	0	0	298
21-27091908-C-T	0.003377087	0.008948938	0.0002001	106	102	4	31388	11398	19990	2	2	0	413
21-27091909-G-A	3.18613E-05	0	5.0035E-05	1	0	1	31386	11400	19986	0	0	0	320
21-27091909-GT-G	3.18613E-05	0	5.0035E-05	1	0	1	31386	11400	19986	0	0	0	138
21-27091914-C-T	6.36983E-05	8.76885E-05	5.0015E-05	2	1	1	31398	11404	19994	0	0	0	352
21-27091926-T-G	3.18451E-05	0	5.003E-05	1	0	1	31402	11414	19988	0	0	0	327
21-27091955-A-G	3.1841E-05	8.75964E-05	0	1	1	0	31406	11416	19990	0	0	0	248
21-27091959-G-A	6.36983E-05	8.76424E-05	5.003E-05	2	1	1	31398	11410	19988	0	0	0	14
21-27091959-G-T	3.18492E-05	8.76424E-05	0	1	1	0	31398	11410	19988	0	0	0	78
21-27091963-G-A	3.18492E-05	0	5.0035E-05	1	0	1	31398	11412	19986	0	0	0	203
21-27091964-A-G	3.18471E-05	0	5.0035E-05	1	0	1	31400	11414	19986	0	0	0	35
21-27091975-A-G	0.031445138	0.086067731	0.00030015	987	981	6	31388	11398	19990	58	58	0	78
21-27091990-T-C	0.00012738	0.00035057	0	4	4	0	31402	11410	19992	0	0	0	408
21-27092008-T-C	3.1839E-05	0	5.001E-05	1	0	1	31408	11412	19996	0	0	0	183
21-27092020-A-G	0.003471116	0.000175254	0.005352676	109	2	107	31402	11412	19990	1	0	1	368
21-27092048-A-T	3.1835E-05	8.76271E-05	0	1	1	0	31412	11412	20000	0	0	0	465
21-27092051-G-A	0.000159195	0	0.000250025	5	0	5	31408	11410	19998	0	0	0	356
21-27092071-T-C	3.18492E-05	0	5.003E-05	1	0	1	31398	11410	19988	0	0	0	437
21-27092090-CAAAG-C	3.18735E-05	0	5.00751E-05	1	0	1	31374	11404	19970	0	0	0	141
21-27092098-C-A	3.18512E-05	0	5.003E-05	1	0	1	31396	11408	19988	0	0	0	237
21-27092119-AG-A	3.1837E-05	0	5.001E-05	1	0	1	31410	11414	19996	0	0	0	440
21-27092121-T-A	0.009616609	0.026200491	0.00015006	302	299	3	31404	11412	19992	4	4	0	111
21-27092124-TTAAC-T	3.1841E-05	0	5.0015E-05	1	0	1	31406	11412	19994	0	0	0	43
21-27092130-A-G	3.1837E-05	8.76117E-05	0	1	1	0	31410	11414	19996	0	0	0	226
21-27092134-A-G	3.1837E-05	0	5.0015E-05	1	0	1	31410	11416	19994	0	0	0	145
21-27092137-T-A	3.18431E-05	8.76424E-05	0	1	1	0	31404	11410	19994	0	0	0	370
21-27092158-A-G	9.55171E-05	0	0.000150045	3	0	3	31408	11414	19994	0	0	0	137
21-27092181-G-A	3.18573E-05	0	5.004E-05	1	0	1	31390	11406	19984	0	0	0	74
21-27092181-G-C	3.18573E-05	8.76732E-05	0	1	1	0	31390	11406	19984	0	0	0	108
21-27092186-A-G	3.18451E-05	8.76117E-05	0	1	1	0	31402	11414	19988	0	0	0	53
21-27092187-T-A	9.55657E-05	0	0.000150105	3	0	3	31392	11406	19986	0	0	0	354
21-27092187-T-C	3.18552E-05	0	5.0035E-05	1	0	1	31392	11406	19986	0	0	0	18
21-27092204-T-C	0.000127389	0.000262789	5.004E-05	4	3	1	31400	11416	19984	0	0	0	364
21-27092222-A-G	3.18431E-05	8.76424E-05	0	1	1	0	31404	11410	19994	0	0	0	113
21-27092234-T-C	3.1837E-05	8.76117E-05	0	1	1	0	31410	11414	19996	0	0	0	32
21-27092252-A-C	6.36902E-05	0.000175285	0	2	2	0	31402	11410	19992	0	0	0	121
21-27092310-TAAG-T	0.54913517	0.345219229	0.665743631	17144	3921	13223	31220	11358	19862	5139	727	4412	133
21-27092325-A-G	3.18552E-05	8.76424E-05	0	1	1	0	31392	11410	19982	0	0	0	353
21-27092349-A-C	3.18512E-05	8.76424E-05	0	1	1	0	31396	11410	19986	0	0	0	458
21-27092349-A-G	3.18512E-05	8.76424E-05	0	1	1	0	31396	11410	19986	0	0	0	241
21-27092371-G-A	9.58773E-05	8.7858E-05	0.000100462	3	1	2	31290	11382	19908	0	0	0	360
21-27092391-T-C	0.000127445	0.000350877	0	4	4	0	31386	11400	19986	0	0	0	216
21-27092400-TAACAG-T	0.006591097	0.017963547	0.00010003	207	205	2	31406	11412	19994	1	1	0	466
21-27092441-AT-A	0.009027689	0.024469391	0.000200541	283	279	4	31348	11402	19946	4	4	0	345
21-27092501-G-C	3.1998E-05	8.79044E-05	0	1	1	0	31252	11376	19876	0	0	0	236
21-27092545-G-A	0.001147959	0.000701385	0.001403227	36	8	28	31360	11406	19954	0	0	0	172
21-27092564-A-C	0.030144669	0.081462645	0.000850936	946	929	17	31382	11404	19978	49	49	0	375
21-27092581-CAAGTT-C	0.000127657	0.000351	0	4	4	0	31334	11396	19938	0	0	0	218
21-27092607-C-T	3.18715E-05	0	5.00551E-05	1	0	1	31376	11398	19978	0	0	0	70
21-27092610-G-T	3.18817E-05	8.77039E-05	0	1	1	0	31366	11402	19964	0	0	0	143
21-27092627-T-C	0.009111762	0.024636156	0.000250225	286	281	5	31388	11406	19982	4	4	0	458
21-27092673-C-A	3.19326E-05	8.77655E-05	0	1	1	0	31316	11394	19922	0	0	0	328
21-27092713-T-C	6.40985E-05	8.79044E-05	5.04388E-05	2	1	1	31202	11376	19826	0	0	0	341
21-27092721-T-G	3.21069E-05	8.80902E-05	0	1	1	0	31146	11352	19794	0	0	0	218
21-27092740-AT-A	3.24781E-05	8.87311E-05	0	1	1	0	30790	11270	19520	0	0	0	197
21-27092765-T-C	0.000483364	0.001377727	0	12	12	0	24826	8710	16116	0	0	0	218
21-27092766-G-GT	5.48546E-05	0	8.30565E-05	1	0	1	18230	6190	12040	0	0	0	248
21-27092767-G-GT	0.04290165	0.08835174	0.01208139	1019	848	171	23752	9598	14154	68	63	5	448
21-27092767-G-GTT	0.000210509	0.000104188	0.000282606	5	1	4	23752	9598	14154	0	0	0	20
21-27092767-G-GTTT	0.001641967	0.000729319	0.002260845	39	7	32	23752	9598	14154	0	0	0	484
21-27092767-G-GTTTT	0.729959582	0.657220254	0.779285008	17338	6308	11030	23752	9598	14154	6456	2130	4326	383
21-27092767-GT-G	0.027029303	0.065221921	0.001130422	642	626	16	23752	9598	14154	37	37	0	163
21-27092767-GTT-G	4.21017E-05	0.000104188	0	1	1	0	23752	9598	14154	0	0	0	384
21-27092777-T-C	3.25669E-05	8.84956E-05	0	1	1	0	30706	11300	19406	0	0	0	35
21-27092781-T-TG	3.24654E-05	8.85112E-05	0	1	1	0	30802	11298	19504	0	0	0	252
21-27092794-T-C	3.306E-05	0	5.20779E-05	1	0	1	30248	11046	19202	0	0	0	84
21-27092798-G-A	0.0002197	0.000575043	0	6	6	0	27310	10434	16876	0	0	0	435
21-27092801-C-G	0.000140795	0	0.000227635	4	0	4	28410	10838	17572	0	0	0	6
21-27092801-C-T	3.51989E-05	9.22679E-05	0	1	1	0	28410	10838	17572	0	0	0	219
21-27092814-T-C	3.22227E-05	0	5.07048E-05	1	0	1	31034	11312	19722	0	0	0	145
21-27092815-G-A	3.27332E-05	0	5.16476E-05	1	0	1	30550	11188	19362	0	0	0	58
21-27092822-C-T	6.52614E-05	8.89996E-05	5.15198E-05	2	1	1	30646	11236	19410	0	0	0	128
21-27092827-C-T	6.48677E-05	0	0.000102103	2	0	2	30832	11244	19588	0	0	0	441
21-27092828-G-A	6.4612E-05	8.86525E-05	5.08285E-05	2	1	1	30954	11280	19674	0	0	0	363
21-27092831-A-T	9.62279E-05	0	0.000151301	3	0	3	31176	11348	19828	0	0	0	101
21-27092842-C-G	0.000256213	0	0.000402779	8	0	8	31224	11362	19862	0	0	0	137
21-27092845-C-A	3.20451E-05	0	5.03474E-05	1	0	1	31206	11344	19862	0	0	0	43
21-27092857-T-A	3.20287E-05	8.81523E-05	0	1	1	0	31222	11344	19878	0	0	0	495
21-27092862-G-T	0.000256033	0.000704473	0	8	8	0	31246	11356	19890	0	0	0	16
21-27092867-T-C	3.19775E-05	8.79198E-05	0	1	1	0	31272	11374	19898	0	0	0	415
21-27092870-C-T	0.000192357	0.000264224	0.000151225	6	3	3	31192	11354	19838	0	0	0	169
21-27092875-C-T	3.19857E-05	8.79198E-05	0	1	1	0	31264	11374	19890	0	0	0	447
21-27092893-T-A	3.18918E-05	0	5.01153E-05	1	0	1	31356	11402	19954	0	0	0	347
21-27092897-A-G	3.19244E-05	8.77809E-05	0	1	1	0	31324	11392	19932	0	0	0	172
21-27092901-C-G	3.1955E-05	0	5.02311E-05	1	0	1	31294	11386	19908	0	0	0	177
21-27092903-G-A	6.38325E-05	0	0.000100301	2	0	2	31332	11392	19940	0	0	0	231
21-27092918-G-C	3.19244E-05	8.77963E-05	0	1	1	0	31324	11390	19934	0	0	0	24
21-27092922-G-A	0.10053705	0.026685393	0.142835596	3145	304	2841	31282	11392	19890	227	6	221	344
21-27092923-G-C	6.3804E-05	8.77193E-05	5.01354E-05	2	1	1	31346	11400	19946	0	0	0	185
21-27092927-A-G	3.19407E-05	8.7858E-05	0	1	1	0	31308	11382	19926	0	0	0	358
21-27092935-A-G	0.003071017	0.000702741	0.00442745	96	8	88	31260	11384	19876	1	0	1	229
21-27092957-C-CA	3.19898E-05	0	5.02866E-05	1	0	1	31260	11374	19886	0	0	0	359
21-27092958-A-G	3.19591E-05	8.78272E-05	0	1	1	0	31290	11386	19904	0	0	0	454
21-27092968-C-G	6.40533E-05	0.000176087	0	2	2	0	31224	11358	19866	0	0	0	331
21-27092972-G-T	3.1998E-05	0	5.03271E-05	1	0	1	31252	11382	19870	0	0	0	143
21-27092999-A-G	3.19898E-05	0	5.03018E-05	1	0	1	31260	11380	19880	0	0	0	387
21-27093000-T-C	6.3955E-05	0.000175654	0	2	2	0	31272	11386	19886	0	0	0	80
21-27093020-A-G	6.39795E-05	0.000175593	0	2	2	0	31260	11390	19870	0	0	0	376
21-27093051-C-T	6.41108E-05	8.77655E-05	5.04999E-05	2	1	1	31196	11394	19802	0	0	0	76
21-27093052-G-A	0.018829794	0.051187335	0.000252474	587	582	5	31174	11370	19804	26	26	0	472
21-27093053-C-T	3.20636E-05	0	5.04745E-05	1	0	1	31188	11376	19812	0	0	0	192
21-27093062-CTTCTTAAT-C	3.19959E-05	8.7858E-05	0	1	1	0	31254	11382	19872	0	0	0	415
21-27093073-C-T	0.023455451	0.064046324	0.000250777	735	730	5	31336	11398	19938	30	30	0	328
21-27093077-T-C	3.18776E-05	0	5.00751E-05	1	0	1	31370	11400	19970	0	0	0	418
21-27093079-C-G	3.19061E-05	8.76885E-05	0	1	1	0	31342	11404	19938	0	0	0	60
21-27093105-T-C	9.55901E-05	0	0.000150195	3	0	3	31384	11410	19974	0	0	0	55
21-27093107-T-C	3.18613E-05	0	5.00551E-05	1	0	1	31386	11408	19978	0	0	0	339
21-27093170-T-C	3.1839E-05	8.76424E-05	0	1	1	0	31408	11410	19998	0	0	0	403
21-27093181-A-G	3.1837E-05	8.76117E-05	0	1	1	0	31410	11414	19996	0	0	0	438
21-27093185-C-G	3.18878E-05	0	5.00952E-05	1	0	1	31360	11398	19962	0	0	0	162
21-27093213-G-T	3.18552E-05	0	5.003E-05	1	0	1	31392	11404	19988	0	0	0	299
21-27093215-C-T	6.37308E-05	0.000175439	0	2	2	0	31382	11400	19982	0	0	0	318
21-27093226-T-C	3.18492E-05	8.76424E-05	0	1	1	0	31398	11410	19988	0	0	0	486
21-27093227-A-G	0.000477646	0.001314406	0	15	15	0	31404	11412	19992	0	0	0	180
21-27093244-G-A	0.002391124	0.006496927	5.00601E-05	75	74	1	31366	11390	19976	0	0	0	284
21-27093244-G-T	3.18817E-05	0	5.00601E-05	1	0	1	31366	11390	19976	0	0	0	436
21-27093258-T-C	3.18674E-05	8.76424E-05	0	1	1	0	31380	11410	19970	0	0	0	99
21-27093287-T-C	0.007084503	0.001052447	0.010534765	222	12	210	31336	11402	19934	1	0	1	13
21-27093311-C-G	0.011776	0.032161687	0.000100654	368	366	2	31250	11380	19870	10	10	0	48
21-27093312-G-A	3.19632E-05	8.77347E-05	0	1	1	0	31286	11398	19888	0	0	0	197
21-27093344-G-A	6.42013E-05	8.79507E-05	5.0551E-05	2	1	1	31152	11370	19782	0	0	0	176
21-27093383-C-T	0.000417577	0.000176243	0.000556005	13	2	11	31132	11348	19784	0	0	0	166
21-27093401-C-T	3.20904E-05	0	5.04999E-05	1	0	1	31162	11360	19802	0	0	0	127
21-27093402-G-T	6.4119E-05	0.000175963	0	2	2	0	31192	11366	19826	0	0	0	363
21-27093423-A-ACTTT	6.40041E-05	0	0.000100563	2	0	2	31248	11360	19888	0	0	0	497
21-27093437-T-G	3.19959E-05	0	5.02765E-05	1	0	1	31254	11364	19890	0	0	0	198
21-27093446-T-A	0.000223971	0.000615655	0	7	7	0	31254	11370	19884	0	0	0	13
21-27093473-C-T	0.02144181	0.007028642	0.029680595	671	80	591	31294	11382	19912	9	0	9	153
21-27093474-G-C	3.19591E-05	0	5.02361E-05	1	0	1	31290	11384	19906	0	0	0	475
21-27093514-G-A	3.19448E-05	8.78272E-05	0	1	1	0	31304	11386	19918	0	0	0	273
21-27093516-G-A	3.19366E-05	8.78117E-05	0	1	1	0	31312	11388	19924	0	0	0	268
21-27093571-C-T	3.26307E-05	8.94294E-05	0	1	1	0	30646	11182	19464	0	0	0	449
21-27093573-C-A	3.22539E-05	8.85269E-05	0	1	1	0	31004	11296	19708	0	0	0	305
21-27093584-GAAAAGAAAAGAAAAAAA-G	0.001145475	0.002931719	5.75971E-05	32	31	1	27936	10574	17362	0	0	0	97
21-27093594-G-C	0.008837731	0.020421187	0.000942439	205	192	13	23196	9402	13794	1	1	0	64
21-27093594-GA-G	4.31109E-05	0.00010636	0	1	1	0	23196	9402	13794	0	0	0	119
21-27093599-A-G	3.20616E-05	0	5.04032E-05	1	0	1	31190	11350	19840	0	0	0	18
21-27093601-AAAAAG-A	3.20431E-05	0	5.03981E-05	1	0	1	31208	11366	19842	0	0	0	419
21-27093646-TTGA-T	6.44164E-05	8.83704E-05	5.06791E-05	2	1	1	31048	11316	19732	0	0	0	82
21-27093673-A-G	3.19285E-05	0	5.01756E-05	1	0	1	31320	11390	19930	0	0	0	224
21-27093679-T-G	3.19142E-05	8.77809E-05	0	1	1	0	31334	11392	19942	0	0	0	104
21-27093682-A-T	3.19326E-05	0	5.01958E-05	1	0	1	31316	11394	19922	0	0	0	65
21-27093689-CACT-C	6.37511E-05	8.76578E-05	5.00902E-05	2	1	1	31372	11408	19964	0	0	0	188
21-27093702-C-T	6.37552E-05	0.000175316	0	2	2	0	31370	11408	19962	0	0	0	287
21-27093712-A-G	6.37552E-05	0	0.00010016	2	0	2	31370	11402	19968	0	0	0	15
21-27093718-CA-C	6.37389E-05	8.76424E-05	5.00801E-05	2	1	1	31378	11410	19968	0	0	0	479
21-27093740-G-A	0.010554847	0.027889844	0.000651368	331	318	13	31360	11402	19958	3	3	0	477
21-27093747-T-C	3.19264E-05	8.78272E-05	0	1	1	0	31322	11386	19936	0	0	0	314
21-27093759-G-A	3.18898E-05	0	5.01052E-05	1	0	1	31358	11400	19958	0	0	0	319
21-27093768-C-T	0.012942605	0.005884419	0.016979805	405	67	338	31292	11386	19906	1	0	1	166
21-27093788-G-C	9.5706E-05	0	0.000150376	3	0	3	31346	11396	19950	0	0	0	16
21-27093801-C-T	3.19428E-05	8.78889E-05	0	1	1	0	31306	11378	19928	0	0	0	390
21-27093809-A-G	3.18857E-05	8.77809E-05	0	1	1	0	31362	11392	19970	0	0	0	5
21-27093810-T-C	3.19203E-05	0	5.01303E-05	1	0	1	31328	11380	19948	0	0	0	134
21-27093821-A-G	3.18695E-05	8.77039E-05	0	1	1	0	31378	11402	19976	0	0	0	446
21-27093841-A-G	3.18634E-05	0	5.0045E-05	1	0	1	31384	11402	19982	0	0	0	345
21-27093846-A-G	9.55962E-05	0	0.000150165	3	0	3	31382	11404	19978	0	0	0	385
21-27093864-G-C	3.18776E-05	0	5.00551E-05	1	0	1	31370	11392	19978	0	0	0	14
21-27093875-C-T	6.37836E-05	0	0.00010022	2	0	2	31356	11400	19956	0	0	0	422
21-27093892-T-A	3.18959E-05	0	5.01052E-05	1	0	1	31352	11394	19958	0	0	0	117
21-27093905-G-A	3.18613E-05	0	5.00551E-05	1	0	1	31386	11408	19978	0	0	0	292
21-27093913-T-C	0.00660245	0.017991926	0.00010021	207	205	2	31352	11394	19958	1	1	0	40
21-27093936-G-GA	0.0039035	0.005886487	0.002767713	122	67	55	31254	11382	19872	1	0	1	22
21-27093954-AG-A	3.19203E-05	8.78117E-05	0	1	1	0	31328	11388	19940	0	0	0	85
21-27093955-G-C	3.18817E-05	0	5.00651E-05	1	0	1	31366	11392	19974	0	0	0	179
21-27093955-G-T	0.001307148	0.003335674	0.000150195	41	38	3	31366	11392	19974	0	0	0	35
21-27093969-C-A	3.19326E-05	8.78117E-05	0	1	1	0	31316	11388	19928	0	0	0	259
21-27093969-C-T	3.19326E-05	0	5.01807E-05	1	0	1	31316	11388	19928	0	0	0	195
21-27093970-G-A	3.18939E-05	8.77501E-05	0	1	1	0	31354	11396	19958	0	0	0	146
21-27093973-G-T	0.000159429	0	0.000250501	5	0	5	31362	11402	19960	0	0	0	310
21-27094003-T-G	0.000255575	0.000702988	0	8	8	0	31302	11380	19922	0	0	0	59
21-27094023-T-C	3.20574E-05	8.80747E-05	0	1	1	0	31194	11354	19840	0	0	0	459
21-27094026-C-T	6.38896E-05	0	0.000100402	2	0	2	31304	11384	19920	0	0	0	37
21-27094069-C-G	3.19775E-05	8.79198E-05	0	1	1	0	31272	11374	19898	0	0	0	144
21-27094096-C-T	3.22061E-05	8.84017E-05	0	1	1	0	31050	11312	19738	0	0	0	157
21-27094101-C-T	3.23311E-05	8.86054E-05	0	1	1	0	30930	11286	19644	0	0	0	480
21-27094103-T-TA	0.000131458	0.00035823	0	4	4	0	30428	11166	19262	0	0	0	197
21-27094112-G-A	0.000512853	0.001407955	0	16	16	0	31198	11364	19834	0	0	0	29
21-27094118-C-T	6.43832E-05	0.00017646	0	2	2	0	31064	11334	19730	0	0	0	463
21-27094119-G-A	0.003477365	0.009544008	0	108	108	0	31058	11316	19742	0	0	0	438
21-27094136-C-T	3.2002E-05	8.79198E-05	0	1	1	0	31248	11374	19874	0	0	0	417
21-27094137-A-G	0.000192123	0.000528169	0	6	6	0	31230	11360	19870	0	0	0	403
21-27094144-C-T	3.20739E-05	0	5.04592E-05	1	0	1	31178	11360	19818	0	0	0	28
21-27094145-G-A	3.20616E-05	8.80282E-05	0	1	1	0	31190	11360	19830	0	0	0	1
21-27094148-T-C	0.002056423	0.005646727	0	64	64	0	31122	11334	19788	1	1	0	205
21-27094149-G-A	3.20287E-05	8.80282E-05	0	1	1	0	31222	11360	19862	0	0	0	249
21-27094154-T-A	3.20287E-05	8.79353E-05	0	1	1	0	31222	11372	19850	0	0	0	483
21-27094154-T-TA	3.20287E-05	8.79353E-05	0	1	1	0	31222	11372	19850	0	0	0	426
21-27094158-C-T	6.41026E-05	0	0.000100786	2	0	2	31200	11356	19844	0	0	0	31
21-27094165-A-G	3.20739E-05	0	5.04236E-05	1	0	1	31178	11346	19832	0	0	0	319
21-27094173-G-A	0.000128172	8.79972E-05	0.000151179	4	1	3	31208	11364	19844	0	0	0	411
21-27094184-G-A	6.41149E-05	0.000176243	0	2	2	0	31194	11348	19846	0	0	0	229
21-27094189-T-A	3.23144E-05	0	5.08233E-05	1	0	1	30946	11270	19676	0	0	0	169
21-27094192-C-T	9.65686E-05	0.000265064	0	3	3	0	31066	11318	19748	0	0	0	265
21-27094193-G-A	6.43459E-05	0.00017671	0	2	2	0	31082	11318	19764	0	0	0	471
21-27094201-G-T	9.65997E-05	8.82924E-05	0.000101368	3	1	2	31056	11326	19730	0	0	0	173
21-27094202-G-A	0.021474565	0.005118249	0.03086983	667	58	609	31060	11332	19728	8	0	8	60
21-27094207-T-C	0.084289293	0.228819696	0.001503526	2557	2528	29	30336	11048	19288	390	388	2	278
21-27094224-C-T	0.000196696	0	0.000310463	6	0	6	30504	11178	19326	0	0	0	156
21-27094225-G-A	3.26456E-05	0	5.15039E-05	1	0	1	30632	11216	19416	0	0	0	279
21-27094231-G-A	0.003026515	0.008187871	5.18565E-05	92	91	1	30398	11114	19284	0	0	0	345
21-27094248-C-T	0.000132083	0.000359324	0	4	4	0	30284	11132	19152	0	0	0	60
21-27094250-T-A	6.68941E-05	0	0.000105485	2	0	2	29898	10938	18960	0	0	0	369
21-27094251-G-C	9.85157E-05	0.000179083	5.18565E-05	3	2	1	30452	11168	19284	0	0	0	433
21-27094252-G-A	0.000164268	0.000447788	0	5	5	0	30438	11166	19272	0	0	0	239
21-27094275-C-A	0.021905674	0.018034649	0.024725843	366	127	239	16708	7042	9666	1	1	0	269
21-27094275-C-CA	0.000837922	0.00028401	0.001241465	14	2	12	16708	7042	9666	0	0	0	167
21-27094275-CA-C	0.01185061	0.019596705	0.006207325	198	138	60	16708	7042	9666	4	4	0	254
21-27094275-CAA-C	0.000239406	0.000142005	0.000310366	4	1	3	16708	7042	9666	0	0	0	148
21-27094275-CAAA-C	0.002753172	0.001278046	0.00382785	46	9	37	16708	7042	9666	0	0	0	309
21-27094288-A-AG	9.82704E-05	0.000276804	0	3	3	0	30528	10838	19690	0	0	0	20
21-27094289-A-AAAAAGAG	0.026506733	0.072907126	0.000762273	811	796	15	30596	10918	19678	41	40	1	252
21-27094289-A-AAAAGAG	3.2684E-05	9.15919E-05	0	1	1	0	30596	10918	19678	0	0	0	28
21-27094289-A-AAAGAG	3.2684E-05	9.15919E-05	0	1	1	0	30596	10918	19678	0	0	0	221
21-27094289-A-AAGAG	0.019839195	0.055321487	0.000152455	607	604	3	30596	10918	19678	25	25	0	183
21-27094289-A-AG	0.000196104	0.000549551	0	6	6	0	30596	10918	19678	0	0	0	293
21-27094289-A-AGAG	0.000457576	0.001099102	0.000101636	14	12	2	30596	10918	19678	0	0	0	15
21-27094304-G-A	3.22248E-05	8.86525E-05	0	1	1	0	31032	11280	19752	0	0	0	421
21-27094311-G-A	0.020591273	0.056698265	0.000202	638	634	4	30984	11182	19802	27	27	0	483
21-27094314-A-T	0.020878189	0.057348963	0.000204457	640	636	4	30654	11090	19564	27	27	0	407
21-27094321-C-T	0.00028965	0	0.000455235	9	0	9	31072	11302	19770	0	0	0	400
21-27094322-C-T	3.20945E-05	0	5.04388E-05	1	0	1	31158	11332	19826	0	0	0	141
21-27094324-G-C	6.4255E-05	0.000176367	0	2	2	0	31126	11340	19786	0	0	0	148
21-27094327-T-C	3.20492E-05	8.80747E-05	0	1	1	0	31202	11354	19848	0	0	0	79
21-27094364-G-A	6.38407E-05	0.000175562	0	2	2	0	31328	11392	19936	0	0	0	29
21-27094365-T-G	3.19E-05	8.77347E-05	0	1	1	0	31348	11398	19950	0	0	0	435
21-27094383-T-C	6.37755E-05	0.000175531	0	2	2	0	31360	11394	19966	0	0	0	482
21-27094393-T-C	0.000159408	0.000350939	5.00801E-05	5	4	1	31366	11398	19968	0	0	0	190
21-27094393-T-G	3.18817E-05	0	5.00801E-05	1	0	1	31366	11398	19968	0	0	0	320
21-27094404-CCTT-C	3.18654E-05	8.76732E-05	0	1	1	0	31382	11406	19976	0	0	0	251
21-27094435-T-C	0.000382848	0.001053371	0	12	12	0	31344	11392	19952	0	0	0	472
21-27094444-G-A	3.18654E-05	8.76271E-05	0	1	1	0	31382	11412	19970	0	0	0	176
21-27094457-A-G	0.023362696	0.063850343	0.000250677	732	727	5	31332	11386	19946	30	30	0	461
21-27094509-T-C	3.19346E-05	0	5.01706E-05	1	0	1	31314	11382	19932	0	0	0	63
21-27094530-C-T	0.000159388	0.000175531	0.00015018	5	2	3	31370	11394	19976	0	0	0	57
21-27094546-A-C	0.000669088	0	0.001051156	21	0	21	31386	11408	19978	0	0	0	181
21-27094551-C-T	3.18613E-05	0	5.00551E-05	1	0	1	31386	11408	19978	0	0	0	46
21-27094551-CAGGGCCCCGCA-C	3.18613E-05	8.76578E-05	0	1	1	0	31386	11408	19978	0	0	0	272
21-27094557-C-T	0.007847891	0.019747235	0.001052526	246	225	21	31346	11394	19952	2	2	0	129
21-27094559-C-T	0.007238059	0.019729919	0.00010021	227	225	2	31362	11404	19958	1	1	0	431
21-27094560-G-A	0.001402525	0.003770607	5.00801E-05	44	43	1	31372	11404	19968	2	2	0	489
21-27094569-C-G	3.18634E-05	0	5.00501E-05	1	0	1	31384	11404	19980	0	0	0	382
21-27094569-C-T	3.18634E-05	8.76885E-05	0	1	1	0	31384	11404	19980	0	0	0	110
21-27094573-C-T	6.37064E-05	0.000175346	0	2	2	0	31394	11406	19988	0	0	0	49
21-27094607-C-T	3.18512E-05	0	5.0025E-05	1	0	1	31396	11406	19990	0	0	0	41
21-27094619-G-A	3.18634E-05	8.77501E-05	0	1	1	0	31384	11396	19988	0	0	0	259
21-27094626-A-C	3.1839E-05	8.76271E-05	0	1	1	0	31408	11412	19996	0	0	0	210
21-27094627-A-G	3.18431E-05	0	5.0015E-05	1	0	1	31404	11410	19994	0	0	0	305
21-27094631-T-C	3.18654E-05	0	5.00551E-05	1	0	1	31382	11404	19978	0	0	0	399
21-27094656-A-G	3.18451E-05	8.76578E-05	0	1	1	0	31402	11408	19994	0	0	0	429
21-27094671-A-G	3.18492E-05	8.76885E-05	0	1	1	0	31398	11404	19994	0	0	0	486
21-27094689-A-G	0.000127421	0	0.0002001	4	0	4	31392	11402	19990	0	0	0	221
21-27094695-T-C	3.1839E-05	8.76271E-05	0	1	1	0	31408	11412	19996	0	0	0	5
21-27094723-G-A	3.18532E-05	8.76578E-05	0	1	1	0	31394	11408	19986	0	0	0	245
21-27094728-A-G	3.1841E-05	0	5.0015E-05	1	0	1	31406	11412	19994	0	0	0	356
21-27094730-G-A	3.18451E-05	8.76732E-05	0	1	1	0	31402	11406	19996	0	0	0	350
21-27094779-C-T	0.003821169	0.001489921	0.005151545	120	17	103	31404	11410	19994	1	0	1	172
21-27094795-G-A	9.55718E-05	0.000175377	5.0035E-05	3	2	1	31390	11404	19986	0	0	0	23
21-27094799-A-G	6.36862E-05	0	0.00010001	2	0	2	31404	11406	19998	0	0	0	166
21-27094843-A-AT	6.36821E-05	0.000175254	0	2	2	0	31406	11412	19994	0	0	0	161
21-27094859-C-T	9.55414E-05	0.000262973	0	3	3	0	31400	11408	19992	0	0	0	388
21-27094865-T-G	6.36943E-05	0.000175285	0	2	2	0	31400	11410	19990	0	0	0	280
21-27094893-G-T	0.001018849	0.002715963	5.0015E-05	32	31	1	31408	11414	19994	0	0	0	188
21-27094899-C-CT	3.18492E-05	0	5.002E-05	1	0	1	31398	11406	19992	0	0	0	146
21-27094905-TTCAA-T	0.000382068	0.000963729	5.0015E-05	12	11	1	31408	11414	19994	0	0	0	487
21-27094945-T-A	3.18451E-05	0	5.003E-05	1	0	1	31402	11414	19988	0	0	0	289
21-27094962-T-C	6.36943E-05	8.76117E-05	5.0035E-05	2	1	1	31400	11414	19986	0	0	0	496
21-27095008-A-G	3.1841E-05	0	5.0015E-05	1	0	1	31406	11412	19994	0	0	0	346
21-27095015-T-C	3.18532E-05	8.77193E-05	0	1	1	0	31394	11400	19994	0	0	0	428
21-27095027-G-A	3.1839E-05	8.75964E-05	0	1	1	0	31408	11416	19992	0	0	0	308
21-27095044-A-G	3.18451E-05	8.76117E-05	0	1	1	0	31402	11414	19988	0	0	0	495
21-27095101-G-A	0.00152876	0.002628351	0.000900721	48	30	18	31398	11414	19984	0	0	0	433
21-27095141-C-T	0.014595284	0.039129672	0.00060054	458	446	12	31380	11398	19982	13	13	0	112
21-27095145-G-C	0.000414065	0.00035057	0.000450315	13	4	9	31396	11410	19986	0	0	0	44
21-27095146-C-A	6.36943E-05	0	0.00010003	2	0	2	31400	11406	19994	0	0	0	245
21-27095146-C-G	0.006815287	0.018499036	0.000150045	214	211	3	31400	11406	19994	3	3	0	366
21-27095159-C-G	3.18512E-05	0	5.0035E-05	1	0	1	31396	11410	19986	0	0	0	67
21-27095167-C-G	0.000127405	0.000350693	0	4	4	0	31396	11406	19990	0	0	0	72
21-27095181-A-C	3.18573E-05	0	5.0035E-05	1	0	1	31390	11404	19986	0	0	0	19
21-27095207-T-C	3.18471E-05	8.76578E-05	0	1	1	0	31400	11408	19992	0	0	0	500
21-27095239-G-A	3.18431E-05	8.76424E-05	0	1	1	0	31404	11410	19994	0	0	0	345
21-27095240-C-A	3.18451E-05	8.76578E-05	0	1	1	0	31402	11408	19994	0	0	0	255
21-27095257-C-T	6.36943E-05	0.000175316	0	2	2	0	31400	11408	19992	0	0	0	420
21-27095263-T-A	0.006273486	0.001840813	0.008802641	197	21	176	31402	11408	19994	0	0	0	282
21-27095290-C-A	3.18471E-05	8.76885E-05	0	1	1	0	31400	11404	19996	0	0	0	136
21-27095310-A-G	3.1835E-05	0	5.0005E-05	1	0	1	31412	11414	19998	0	0	0	96
21-27095349-C-G	3.19163E-05	0	5.01454E-05	1	0	1	31332	11390	19942	0	0	0	188
21-27095383-G-A	3.1841E-05	0	5.0015E-05	1	0	1	31406	11412	19994	0	0	0	462
21-27095430-A-G	3.18471E-05	8.76578E-05	0	1	1	0	31400	11408	19992	0	0	0	274
21-27095445-G-T	6.3678E-05	0.000175316	0	2	2	0	31408	11408	20000	0	0	0	411
21-27095453-A-G	3.18329E-05	8.75964E-05	0	1	1	0	31414	11416	19998	0	0	0	139
21-27095508-T-C	0.000445775	0.001139551	5.0005E-05	14	13	1	31406	11408	19998	0	0	0	379
21-27095510-GC-G	3.18431E-05	8.76424E-05	0	1	1	0	31404	11410	19994	0	0	0	73
21-27095516-C-T	0.000191083	0.000175316	0.00020008	6	2	4	31400	11408	19992	0	0	0	443
21-27095544-T-C	9.55657E-05	0	0.000150105	3	0	3	31392	11406	19986	0	0	0	164
21-27095550-G-A	3.18451E-05	0	5.0025E-05	1	0	1	31402	11412	19990	0	0	0	267
21-27095566-C-A	3.18512E-05	0	5.0025E-05	1	0	1	31396	11406	19990	0	0	0	383
21-27095567-C-T	3.18573E-05	0	5.004E-05	1	0	1	31390	11406	19984	0	0	0	272
21-27095568-C-T	3.18492E-05	0	5.002E-05	1	0	1	31398	11406	19992	0	0	0	206
21-27095589-G-A	0.000127397	0.000175316	0.00010005	4	2	2	31398	11408	19990	0	0	0	350
21-27095593-A-C	3.18573E-05	0	5.0045E-05	1	0	1	31390	11408	19982	0	0	0	454
21-27095643-G-C	3.18451E-05	8.76424E-05	0	1	1	0	31402	11410	19992	0	0	0	377
21-27095644-C-CAAT	3.18532E-05	8.76885E-05	0	1	1	0	31394	11404	19990	0	0	0	345
21-27095652-T-C	9.55718E-05	0.000262927	0	3	3	0	31390	11410	19980	0	0	0	221
21-27095686-T-C	3.1837E-05	0	0.00005	1	0	1	31410	11410	20000	0	0	0	270
21-27095720-C-G	0.006341619	0.001754386	0.008958959	199	20	179	31380	11400	19980	1	0	1	278
21-27095736-C-T	3.18573E-05	0	5.004E-05	1	0	1	31390	11406	19984	0	0	0	397
21-27095739-A-C	3.18532E-05	8.77193E-05	0	1	1	0	31394	11400	19994	0	0	0	307
21-27095740-A-G	3.18532E-05	8.76885E-05	0	1	1	0	31394	11404	19990	0	0	0	315
21-27095744-C-T	3.18654E-05	8.76885E-05	0	1	1	0	31382	11404	19978	0	0	0	228
21-27095745-G-A	0.00019129	0.000175562	0.00020026	6	2	4	31366	11392	19974	0	0	0	113
21-27095753-A-G	3.1839E-05	0	5.0015E-05	1	0	1	31408	11414	19994	0	0	0	368
21-27095757-C-T	0.002133758	0.005782373	5.0035E-05	67	66	1	31400	11414	19986	0	0	0	220
21-27095768-T-C	0.00070028	0.00192712	0	22	22	0	31416	11416	20000	0	0	0	485
21-27095770-T-C	3.1837E-05	8.75964E-05	0	1	1	0	31410	11416	19994	0	0	0	23
21-27095790-T-C	3.18552E-05	8.76732E-05	0	1	1	0	31392	11406	19986	0	0	0	119
21-27095801-T-C	0.001532078	0.003860326	0.000200682	48	44	4	31330	11398	19932	0	0	0	180
21-27095809-G-A	3.18939E-05	0	5.00902E-05	1	0	1	31354	11390	19964	0	0	0	460
21-27095823-G-A	9.56206E-05	0.00026325	0	3	3	0	31374	11396	19978	0	0	0	62
21-27095828-G-A	3.18796E-05	0	5.01002E-05	1	0	1	31368	11408	19960	0	0	0	287
21-27095832-T-C	0.000127429	0.000350693	0	4	4	0	31390	11406	19984	0	0	0	471
21-27095861-A-G	3.18674E-05	0	5.00601E-05	1	0	1	31380	11404	19976	0	0	0	132
21-27095878-C-T	9.56816E-05	0.000175285	5.01404E-05	3	2	1	31354	11410	19944	0	0	0	151
21-27095888-C-T	3.18654E-05	0	5.00751E-05	1	0	1	31382	11412	19970	0	0	0	414
21-27095895-G-A	3.19142E-05	0	5.01807E-05	1	0	1	31334	11406	19928	0	0	0	11
21-27095918-C-T	9.57365E-05	8.76885E-05	0.000100341	3	1	2	31336	11404	19932	0	0	0	309
21-27095919-G-A	3.19081E-05	0	5.01354E-05	1	0	1	31340	11394	19946	0	0	0	19
21-27095921-G-A	0.001306981	0.00359523	0	41	41	0	31370	11404	19966	1	1	0	115
21-27095942-C-G	3.18817E-05	0	5.00701E-05	1	0	1	31366	11394	19972	0	0	0	185
21-27095956-T-C	3.19142E-05	0	5.01605E-05	1	0	1	31334	11398	19936	0	0	0	59
21-27095963-G-A	3.19101E-05	8.77963E-05	0	1	1	0	31338	11390	19948	0	0	0	259
21-27095965-C-T	3.19366E-05	8.78426E-05	0	1	1	0	31312	11384	19928	0	0	0	48
21-27095968-C-T	3.1904E-05	0	5.01354E-05	1	0	1	31344	11398	19946	0	0	0	435
21-27095978-C-A	3.1953E-05	0	5.0221E-05	1	0	1	31296	11384	19912	0	0	0	215
21-27095978-C-T	6.39059E-05	8.78426E-05	5.0221E-05	2	1	1	31296	11384	19912	0	0	0	230
21-27096001-A-C	0.000127747	0.000175593	0.000100392	4	2	2	31312	11390	19922	0	0	0	199
21-27096014-A-G	0.000223814	0.000263759	0.000200985	7	3	4	31276	11374	19902	0	0	0	25
21-27096019-GGC-G	6.40328E-05	0.000175963	0	2	2	0	31234	11366	19868	0	0	0	498
21-27096021-C-T	0.005396377	0.014462081	0.000202102	168	164	4	31132	11340	19792	2	2	0	261
21-27096022-G-A	9.68304E-05	0.000176866	5.08285E-05	3	2	1	30982	11308	19674	0	0	0	230
21-27096023-C-A	3.21069E-05	0	5.05255E-05	1	0	1	31146	11354	19792	0	0	0	262
21-27096023-C-G	3.21069E-05	0	5.05255E-05	1	0	1	31146	11354	19792	0	0	0	410
21-27096024-A-ATG	3.20513E-05	0	5.04185E-05	1	0	1	31200	11366	19834	0	0	0	186
21-27096024-A-G	6.41026E-05	0.000175963	0	2	2	0	31200	11366	19834	0	0	0	105
21-27096032-A-T	3.19836E-05	0	5.03018E-05	1	0	1	31266	11386	19880	0	0	0	298
21-27096035-C-A	6.41931E-05	0	0.00010102	2	0	2	31156	11358	19798	0	0	0	336
21-27096044-C-T	3.21937E-05	0	5.07357E-05	1	0	1	31062	11352	19710	0	0	0	229
21-27096062-AGAATTGCTT-A	3.20205E-05	8.78272E-05	0	1	1	0	31230	11386	19844	0	0	0	290
21-27096065-A-C	3.20369E-05	8.77809E-05	0	1	1	0	31214	11392	19822	0	0	0	491
21-27096067-T-G	3.21937E-05	8.80437E-05	0	1	1	0	31062	11358	19704	0	0	0	173
21-27096076-C-G	3.22581E-05	8.82457E-05	0	1	1	0	31000	11332	19668	0	0	0	325
21-27096087-A-G	6.42963E-05	8.82301E-05	5.05766E-05	2	1	1	31106	11334	19772	0	0	0	229
21-27096089-C-T	0.000198781	8.95897E-05	0.000262854	6	1	5	30184	11162	19022	0	0	0	351
21-27096090-G-A	3.36746E-05	0	5.36136E-05	1	0	1	29696	11044	18652	0	0	0	25
21-27096091-A-G	3.22935E-05	8.86682E-05	0	1	1	0	30966	11278	19688	0	0	0	379
21-27096094-C-G	6.69299E-05	0.000180963	0	2	2	0	29882	11052	18830	0	0	0	150
21-27096103-C-A	0.020017971	0.039948754	0.005067272	401	343	58	20032	8586	11446	6	6	0	38
21-27096103-C-CA	4.99201E-05	0	8.73668E-05	1	0	1	20032	8586	11446	0	0	0	481
21-27096103-C-CAA	0.00014976	0	0.0002621	3	0	3	20032	8586	11446	0	0	0	448
21-27096103-CA-C	0.024361022	0.033775914	0.01729862	488	290	198	20032	8586	11446	2	2	0	464
21-27096103-CAA-C	0.002645767	0.001397624	0.003582037	53	12	41	20032	8586	11446	0	0	0	239
21-27096103-CAAA-C	0.000798722	0.000232937	0.001223135	16	2	14	20032	8586	11446	0	0	0	122
21-27096114-A-G	3.19224E-05	8.77347E-05	0	1	1	0	31326	11398	19928	0	0	0	173
21-27096115-A-G	3.19468E-05	8.77347E-05	0	1	1	0	31302	11398	19904	0	0	0	4
21-27096139-T-C	6.38284E-05	0	0.000100331	2	0	2	31334	11400	19934	0	0	0	175
21-27096140-T-C	6.38203E-05	0.000175469	0	2	2	0	31338	11398	19940	0	0	0	287
21-27096230-C-A	3.18857E-05	8.76885E-05	0	1	1	0	31362	11404	19958	0	0	0	290
21-27096256-T-C	3.1839E-05	0	5.0015E-05	1	0	1	31408	11414	19994	0	0	0	399
21-27096258-T-A	0.009299955	0.025245442	0.0002001	292	288	4	31398	11408	19990	4	4	0	500
21-27096276-T-C	3.18532E-05	0	5.0045E-05	1	0	1	31394	11412	19982	0	0	0	380
21-27096310-C-G	0.000254923	0	0.00040036	8	0	8	31382	11400	19982	0	0	0	31
21-27096316-T-C	3.18512E-05	8.76424E-05	0	1	1	0	31396	11410	19986	0	0	0	365
21-27096376-CTCT-C	3.18695E-05	0	5.00601E-05	1	0	1	31378	11402	19976	0	0	0	175
21-27096382-T-C	3.18573E-05	8.77039E-05	0	1	1	0	31390	11402	19988	0	0	0	362
21-27096386-T-G	3.18573E-05	8.76578E-05	0	1	1	0	31390	11408	19982	0	0	0	104
21-27096423-G-C	3.18674E-05	0	5.004E-05	1	0	1	31380	11396	19984	0	0	0	209
21-27096427-G-A	3.18715E-05	0	5.00551E-05	1	0	1	31376	11398	19978	0	0	0	217
21-27096429-T-C	3.18492E-05	8.76885E-05	0	1	1	0	31398	11404	19994	0	0	0	343
21-27096431-C-CT	3.18654E-05	8.77039E-05	0	1	1	0	31382	11402	19980	0	0	0	327
21-27096443-C-G	3.18695E-05	0	5.004E-05	1	0	1	31378	11394	19984	0	0	0	232
21-27096445-C-T	0.000159286	0.00043852	0	5	5	0	31390	11402	19988	0	0	0	350
21-27096446-G-A	0.000127559	0	0.0002003	4	0	4	31358	11388	19970	0	0	0	392
21-27096456-C-T	3.18512E-05	8.76885E-05	0	1	1	0	31396	11404	19992	0	0	0	240
21-27096469-A-C	3.18613E-05	8.77193E-05	0	1	1	0	31386	11400	19986	0	0	0	88
21-27096475-A-T	0.003057909	0.001754386	0.00380114	96	20	76	31394	11400	19994	0	0	0	58
21-27096477-C-T	3.18512E-05	0	5.0025E-05	1	0	1	31396	11406	19990	0	0	0	215
21-27096484-G-A	6.36902E-05	0	0.00010004	2	0	2	31402	11410	19992	0	0	0	270
21-27096497-T-C	0.024743647	0.03445555	0.019203841	777	393	384	31402	11406	19996	14	8	6	492
21-27096524-G-C	3.18492E-05	8.76578E-05	0	1	1	0	31398	11408	19990	0	0	0	461
21-27096542-T-C	3.1841E-05	0	5.0015E-05	1	0	1	31406	11412	19994	0	0	0	14
21-27096549-C-T	3.18532E-05	8.76271E-05	0	1	1	0	31394	11412	19982	0	0	0	335
21-27096559-G-T	6.37186E-05	0.000175285	0	2	2	0	31388	11410	19978	0	0	0	277
21-27096601-A-C	0.002006369	0.005523409	0	63	63	0	31400	11406	19994	1	1	0	194
21-27096616-C-T	3.18613E-05	8.76885E-05	0	1	1	0	31386	11404	19982	0	0	0	444
21-27096635-G-T	9.55901E-05	8.77193E-05	0.00010008	3	1	2	31384	11400	19984	0	0	0	100
21-27096637-A-C	3.18492E-05	8.76885E-05	0	1	1	0	31398	11404	19994	0	0	0	199
21-27096653-T-C	3.18451E-05	8.76424E-05	0	1	1	0	31402	11410	19992	0	0	0	491
21-27096704-G-A	3.18512E-05	8.76885E-05	0	1	1	0	31396	11404	19992	0	0	0	249
21-27096709-T-C	0.000222887	0.000613497	0	7	7	0	31406	11410	19996	0	0	0	324
21-27096718-G-A	3.18431E-05	0	5.002E-05	1	0	1	31404	11412	19992	0	0	0	274
21-27096747-A-AT	3.1839E-05	0	5.001E-05	1	0	1	31408	11412	19996	0	0	0	27
21-27096818-C-T	6.3674E-05	0	0.00010002	2	0	2	31410	11414	19996	0	0	0	208
21-27096822-A-G	3.18431E-05	0	5.0015E-05	1	0	1	31404	11410	19994	0	0	0	476
21-27096840-CAG-C	3.18431E-05	0	5.0025E-05	1	0	1	31404	11414	19990	0	0	0	206
21-27096860-A-C	3.18431E-05	8.76578E-05	0	1	1	0	31404	11408	19996	0	0	0	395
21-27096863-G-A	3.18451E-05	8.76424E-05	0	1	1	0	31402	11410	19992	0	0	0	80
21-27096907-A-C	3.18451E-05	0	5.001E-05	1	0	1	31402	11406	19996	0	0	0	455
21-27096915-C-T	0.00025481	8.76578E-05	0.00035021	8	1	7	31396	11408	19988	0	0	0	325
21-27096930-G-A	3.18451E-05	8.76117E-05	0	1	1	0	31402	11414	19988	0	0	0	294
21-27096935-A-G	3.18431E-05	0	5.0025E-05	1	0	1	31404	11414	19990	0	0	0	252
21-27096944-T-C	0.000127372	0	0.00020008	4	0	4	31404	11412	19992	0	0	0	316
21-27096946-T-C	3.1835E-05	8.75964E-05	0	1	1	0	31412	11416	19996	0	0	0	365
21-27096954-G-T	9.55292E-05	0.000262835	0	3	3	0	31404	11414	19990	0	0	0	180
21-27096969-G-A	3.18878E-05	8.76732E-05	0	1	1	0	31360	11406	19954	0	0	0	488
21-27096978-A-G	3.18471E-05	0	5.003E-05	1	0	1	31400	11412	19988	0	0	0	420
21-27097000-G-A	6.40369E-05	0	0.000100796	2	0	2	31232	11390	19842	0	0	0	338
21-27097011-G-A	0.042046251	0.114473684	0.000750225	1320	1305	15	31394	11400	19994	86	86	0	322
21-27097014-A-G	3.18512E-05	0	5.0035E-05	1	0	1	31396	11410	19986	0	0	0	136
21-27097053-G-T	0.180852421	0.192409067	0.174263675	5669	2190	3479	31346	11382	19964	522	220	302	349
21-27097081-A-AT	0.000892118	0.001753771	0.00040036	28	20	8	31386	11404	19982	0	0	0	47
21-27097096-ACT-A	3.18593E-05	0	5.003E-05	1	0	1	31388	11400	19988	0	0	0	138
21-27097099-G-A	3.18634E-05	8.76732E-05	0	1	1	0	31384	11406	19978	0	0	0	393
21-27097116-T-C	3.18431E-05	8.76578E-05	0	1	1	0	31404	11408	19996	0	0	0	220
21-27097132-C-A	3.18512E-05	0	5.002E-05	1	0	1	31396	11404	19992	0	0	0	226
21-27097139-G-A	0.001943294	0.005349	0	61	61	0	31390	11404	19986	1	1	0	28
21-27097151-A-G	3.18471E-05	0	5.002E-05	1	0	1	31400	11408	19992	0	0	0	499
21-27097205-T-C	3.1837E-05	0	0.00005	1	0	1	31410	11410	20000	0	0	0	450
21-27097218-C-A	0.000636862	0	0.0010002	20	0	20	31404	11408	19996	0	0	0	325
21-27097226-C-T	3.18552E-05	8.77193E-05	0	1	1	0	31392	11400	19992	0	0	0	311
21-27097236-G-A	3.1839E-05	0	5.001E-05	1	0	1	31408	11412	19996	0	0	0	14
21-27097268-T-G	6.36699E-05	8.75964E-05	5.001E-05	2	1	1	31412	11416	19996	0	0	0	114
21-27097278-A-C	3.18431E-05	0	5.0015E-05	1	0	1	31404	11410	19994	0	0	0	359
21-27097293-T-G	6.36943E-05	0.000175346	0	2	2	0	31400	11406	19994	0	0	0	434
21-27097295-T-C	6.36902E-05	0.000175316	0	2	2	0	31402	11408	19994	0	0	0	159
21-27097319-G-A	0.001019238	0.000350754	0.00140056	32	4	28	31396	11404	19992	1	0	1	265
21-27097351-T-C	0.00331168	0.009028752	5.001E-05	104	103	1	31404	11408	19996	1	1	0	112
21-27097353-T-C	3.18431E-05	8.76424E-05	0	1	1	0	31404	11410	19994	0	0	0	164
21-27097397-C-T	6.37146E-05	0.000175469	0	2	2	0	31390	11398	19992	0	0	0	434
21-27097408-C-T	3.1839E-05	0	5.0005E-05	1	0	1	31408	11410	19998	0	0	0	449
21-27097411-G-A	3.18431E-05	8.76578E-05	0	1	1	0	31404	11408	19996	0	0	0	332
21-27097416-C-G	6.36902E-05	0	0.00010002	2	0	2	31402	11406	19996	0	0	0	297
21-27097416-C-T	0.000382141	0	0.00060012	12	0	12	31402	11406	19996	0	0	0	126
21-27097417-G-A	0.000318451	0.000876578	0	10	10	0	31402	11408	19994	0	0	0	470
21-27097428-A-G	3.1839E-05	0	5.0005E-05	1	0	1	31408	11410	19998	0	0	0	156
21-27097438-CAT-C	6.3674E-05	0	0.00010001	2	0	2	31410	11412	19998	0	0	0	268
21-27097441-GTCAA-G	6.36821E-05	0	0.00010003	2	0	2	31406	11412	19994	0	0	0	421
21-27097446-C-G	6.3678E-05	0	0.00010004	2	0	2	31408	11416	19992	0	0	0	85
21-27097458-G-A	0.287899106	0.483371459	0.176556079	9017	5494	3523	31320	11366	19954	1721	1409	312	290
21-27097479-G-A	6.36862E-05	0	0.00010002	2	0	2	31404	11408	19996	0	0	0	414
21-27097498-A-T	3.18471E-05	0	5.0025E-05	1	0	1	31400	11410	19990	0	0	0	427
21-27097509-G-T	9.55901E-05	0	0.000150135	3	0	3	31384	11402	19982	0	0	0	34
21-27097518-T-C	3.18593E-05	0	5.004E-05	1	0	1	31388	11404	19984	0	0	0	25
21-27097533-G-A	0.000254923	0.000263204	0.0002502	8	3	5	31382	11398	19984	0	0	0	301
21-27097554-G-A	3.18532E-05	8.76885E-05	0	1	1	0	31394	11404	19990	0	0	0	370
21-27097567-T-C	6.37024E-05	8.76578E-05	5.003E-05	2	1	1	31396	11408	19988	0	0	0	404
21-27097678-C-G	3.18939E-05	0	5.01052E-05	1	0	1	31354	11396	19958	0	0	0	218
21-27097696-G-A	3.19163E-05	0	5.01605E-05	1	0	1	31332	11396	19936	0	0	0	134
21-27097736-C-A	3.19611E-05	8.78735E-05	0	1	1	0	31288	11380	19908	0	0	0	159
21-27097749-C-CTTT	0.001933086	0.000959693	0.002548544	52	10	42	26900	10420	16480	0	0	0	196
21-27097749-C-CTTTT	0.006208178	0.002783109	0.008373786	167	29	138	26900	10420	16480	0	0	0	496
21-27097760-T-C	6.39836E-05	0	0.000100685	2	0	2	31258	11394	19864	0	0	0	233
21-27097775-G-A	3.42067E-05	0	5.48426E-05	1	0	1	29234	11000	18234	0	0	0	110
21-27097787-G-A	3.31411E-05	0	5.27037E-05	1	0	1	30174	11200	18974	0	0	0	88
21-27097805-C-T	0.036326715	0.037030506	0.035921146	1127	420	707	31024	11342	19682	26	14	12	169
21-27097823-T-C	3.19632E-05	8.77809E-05	0	1	1	0	31286	11392	19894	0	0	0	149
21-27097859-T-C	9.57732E-05	0.0001755	5.01807E-05	3	2	1	31324	11396	19928	0	0	0	4
21-27097877-A-C	3.19346E-05	8.77501E-05	0	1	1	0	31314	11396	19918	0	0	0	431
21-27097899-C-T	0.00949185	0.025663561	0.000251105	297	292	5	31290	11378	19912	4	4	0	361
21-27097900-G-A	6.38692E-05	8.78889E-05	5.01605E-05	2	1	1	31314	11378	19936	0	0	0	15
21-27097901-C-T	6.38121E-05	8.78272E-05	5.01102E-05	2	1	1	31342	11386	19956	0	0	0	100
21-27097904-C-A	3.18837E-05	0	5.00801E-05	1	0	1	31364	11396	19968	0	0	0	465
21-27097910-C-A	0.000638121	0.001756235	0	20	20	0	31342	11388	19954	0	0	0	319
21-27097939-G-A	3.20328E-05	0	5.03626E-05	1	0	1	31218	11362	19856	0	0	0	236
21-27097939-G-C	3.20328E-05	8.80127E-05	0	1	1	0	31218	11362	19856	0	0	0	316
21-27097943-G-A	3.19632E-05	0	5.02008E-05	1	0	1	31286	11366	19920	0	0	0	11
21-27097971-G-C	0.002331375	0.006323555	5.01857E-05	73	72	1	31312	11386	19926	1	1	0	7
21-27097982-C-A	0.092623317	0.107142857	0.084327685	2903	1221	1682	31342	11396	19946	142	70	72	393
21-27097982-C-T	0.000925276	0.002457002	5.01354E-05	29	28	1	31342	11396	19946	0	0	0	175
21-27097991-C-T	0.001339542	0.000175377	0.002005013	42	2	40	31354	11404	19950	0	0	0	1
21-27097992-G-A	0.000159714	0.000263389	0.000100422	5	3	2	31306	11390	19916	0	0	0	412
21-27097996-G-A	0.010554174	0.004822869	0.013829041	331	55	276	31362	11404	19958	1	0	1	408
21-27098000-C-T	0.11334523	0.167601683	0.082357064	3557	1912	1645	31382	11408	19974	248	188	60	272
21-27098018-C-T	0.033511893	0.090789474	0.000801523	1051	1035	16	31362	11400	19962	49	49	0	181
21-27098019-G-A	3.18796E-05	0	5.00952E-05	1	0	1	31368	11406	19962	0	0	0	38
21-27098029-C-T	6.36983E-05	0	0.00010006	2	0	2	31398	11410	19988	0	0	0	60
21-27098030-G-A	0.006499713	0.01771619	0.00010008	204	202	2	31386	11402	19984	1	1	0	305
21-27098031-T-A	0.000159205	0.000438059	0	5	5	0	31406	11414	19992	0	0	0	343
21-27098032-G-A	0.000222987	0.000613604	0	7	7	0	31392	11408	19984	0	0	0	428
21-27098035-C-T	0.00082792	0.002190293	5.0025E-05	26	25	1	31404	11414	19990	0	0	0	491
21-27098040-A-G	0.000191083	0.00035057	0.00010005	6	4	2	31400	11410	19990	0	0	0	447
21-27098041-C-T	6.36862E-05	0.000175285	0	2	2	0	31404	11410	19994	0	0	0	479
21-27098042-A-G	0.000127405	0.000175316	0.00010006	4	2	2	31396	11408	19988	0	0	0	30
21-27098045-C-T	0.000223001	0.000613497	0	7	7	0	31390	11410	19980	0	0	0	359
21-27098046-G-A	0.000127462	0.000262927	5.00701E-05	4	3	1	31382	11410	19972	0	0	0	179
21-27098052-T-C	0.000222958	0.000613604	0	7	7	0	31396	11408	19988	0	0	0	99
21-27098066-G-A	3.18593E-05	0	5.00601E-05	1	0	1	31388	11412	19976	0	0	0	28
21-27098071-C-T	3.18431E-05	0	5.002E-05	1	0	1	31404	11412	19992	0	0	0	366
21-27098072-A-C	3.18431E-05	8.76578E-05	0	1	1	0	31404	11408	19996	0	0	0	451
21-27098073-T-G	3.1837E-05	0	5.001E-05	1	0	1	31410	11414	19996	0	0	0	465
21-27098090-C-T	3.18512E-05	0	5.004E-05	1	0	1	31396	11412	19984	0	0	0	218
21-27098095-G-C	3.18573E-05	8.76424E-05	0	1	1	0	31390	11410	19980	0	0	0	474
21-27098095-GA-G	3.18573E-05	8.76424E-05	0	1	1	0	31390	11410	19980	0	0	0	463
21-27098107-G-A	3.18512E-05	8.76424E-05	0	1	1	0	31396	11410	19986	0	0	0	389
21-27098116-C-T	3.18492E-05	8.76271E-05	0	1	1	0	31398	11412	19986	0	0	0	226
21-27098145-C-G	6.36821E-05	0.000175193	0	2	2	0	31406	11416	19990	0	0	0	55
21-27098145-C-T	3.1841E-05	8.75964E-05	0	1	1	0	31406	11416	19990	0	0	0	177
21-27098168-G-T	3.1841E-05	0	5.002E-05	1	0	1	31406	11414	19992	0	0	0	26
21-27098181-A-G	3.1837E-05	8.76117E-05	0	1	1	0	31410	11414	19996	0	0	0	451
21-27098186-C-CT	0.000413907	0.001138952	0	13	13	0	31408	11414	19994	0	0	0	420
21-27098212-C-T	3.18329E-05	0	0.00005	1	0	1	31414	11414	20000	0	0	0	360
21-27098241-G-T	0.000127364	0	0.00020006	4	0	4	31406	11412	19994	0	0	0	413
21-27098242-G-A	6.36821E-05	0.000175223	0	2	2	0	31406	11414	19992	0	0	0	457
21-27098260-G-GT	6.36862E-05	0	0.00010005	2	0	2	31404	11414	19990	0	0	0	396
21-27098264-C-A	3.18431E-05	0	5.0015E-05	1	0	1	31404	11410	19994	0	0	0	257
21-27098270-G-T	0.000795925	0.002189909	0	25	25	0	31410	11416	19994	1	1	0	499
21-27098294-C-T	3.18431E-05	0	5.0025E-05	1	0	1	31404	11414	19990	0	0	0	392
21-27098301-T-C	0.009650911	0.026380368	0.00010007	303	301	2	31396	11410	19986	5	5	0	463
21-27098309-T-C	0.00035043	0	0.000550385	11	0	11	31390	11404	19986	0	0	0	34
21-27098334-C-T	0.000286642	8.76732E-05	0.00040016	9	1	8	31398	11406	19992	1	0	1	396
21-27098353-C-T	3.18492E-05	0	5.0015E-05	1	0	1	31398	11404	19994	0	0	0	157
21-27098358-C-T	9.55231E-05	0	0.00015006	3	0	3	31406	11414	19992	0	0	0	276
21-27098368-T-A	6.36862E-05	0.000175346	0	2	2	0	31404	11406	19998	0	0	0	479
21-27098395-T-C	3.18492E-05	0	5.0035E-05	1	0	1	31398	11412	19986	0	0	0	285
21-27098405-C-T	6.36699E-05	0.000175223	0	2	2	0	31412	11414	19998	0	0	0	351
21-27098415-A-G	6.36821E-05	0	0.00010001	2	0	2	31406	11408	19998	0	0	0	372
21-27098423-C-T	3.1841E-05	0	5.001E-05	1	0	1	31406	11410	19996	0	0	0	351
21-27098424-G-A	3.18451E-05	8.76578E-05	0	1	1	0	31402	11408	19994	0	0	0	360
21-27098430-C-G	0.00063674	0.001752541	0	20	20	0	31410	11412	19998	0	0	0	407
21-27098447-C-T	3.1837E-05	8.76424E-05	0	1	1	0	31410	11410	20000	0	0	0	432
21-27098453-G-C	0.02149134	0.010778128	0.027605521	675	123	552	31408	11412	19996	9	2	7	330
21-27098474-A-G	3.18431E-05	8.76117E-05	0	1	1	0	31404	11414	19990	0	0	0	230
21-27098475-C-T	3.1839E-05	8.76271E-05	0	1	1	0	31408	11412	19996	0	0	0	450
21-27098491-T-G	3.1837E-05	8.76117E-05	0	1	1	0	31410	11414	19996	0	0	0	368
21-27098494-G-A	3.1841E-05	8.76117E-05	0	1	1	0	31406	11414	19992	0	0	0	107
21-27098508-A-T	0.000222944	0	0.000350105	7	0	7	31398	11404	19994	0	0	0	55
21-27098530-CTT-C	0.000700726	0.001927795	0	22	22	0	31396	11412	19984	0	0	0	151
21-27098550-G-C	6.37227E-05	8.76885E-05	5.0045E-05	2	1	1	31386	11404	19982	0	0	0	334
21-27098569-A-T	0.00098745	0.002718344	0	31	31	0	31394	11404	19990	0	0	0	400
21-27098571-T-A	3.18471E-05	8.76424E-05	0	1	1	0	31400	11410	19990	0	0	0	281
21-27098581-C-A	0.00468302	0.012807018	5.0025E-05	147	146	1	31390	11400	19990	2	2	0	91
21-27098601-T-C	0.000127689	0.000351062	0	4	4	0	31326	11394	19932	0	0	0	45
21-27098602-C-T	6.40615E-05	0.000175716	0	2	2	0	31220	11382	19838	0	0	0	384
21-27098603-G-A	3.20082E-05	0	5.03626E-05	1	0	1	31242	11386	19856	0	0	0	261
21-27098607-A-G	6.36943E-05	0	0.00010004	2	0	2	31400	11408	19992	0	0	0	280
21-27098616-A-C	0.000127356	0.00035057	0	4	4	0	31408	11410	19998	0	0	0	375
21-27098619-T-C	6.36862E-05	0	0.00010003	2	0	2	31404	11410	19994	0	0	0	421
21-27098644-G-T	0.00012734	0.000350385	0	4	4	0	31412	11416	19996	0	0	0	66
21-27098653-T-C	3.18329E-05	8.75964E-05	0	1	1	0	31414	11416	19998	0	0	0	211
21-27098659-G-A	0.00012734	0.000262835	5.0005E-05	4	3	1	31412	11414	19998	0	0	0	418
21-27098710-CT-C	3.18451E-05	0	5.0025E-05	1	0	1	31402	11412	19990	0	0	0	234
21-27098735-T-C	6.37227E-05	0	0.00010007	2	0	2	31386	11400	19986	0	0	0	342
21-27098748-A-C	3.18451E-05	8.76578E-05	0	1	1	0	31402	11408	19994	0	0	0	407
21-27098782-C-G	3.18654E-05	0	5.0045E-05	1	0	1	31382	11400	19982	0	0	0	250
21-27098814-A-G	9.55718E-05	8.77347E-05	0.00010004	3	1	2	31390	11398	19992	0	0	0	234
21-27098826-T-C	0.000159429	0	0.000250275	5	0	5	31362	11384	19978	0	0	0	485
21-27098830-G-A	3.18512E-05	0	5.001E-05	1	0	1	31396	11400	19996	0	0	0	221
21-27098832-T-C	0.00028743	0.000791418	0	9	9	0	31312	11372	19940	0	0	0	242
21-27098853-T-C	0.000318552	0.000877039	0	10	10	0	31392	11402	19990	0	0	0	257
21-27098874-G-T	3.18451E-05	0	5.0025E-05	1	0	1	31402	11412	19990	0	0	0	282
21-27098901-A-G	0.001815171	0	0.002851711	57	0	57	31402	11414	19988	0	0	0	192
21-27098902-T-C	6.3678E-05	0.000175223	0	2	2	0	31408	11414	19994	0	0	0	7
21-27098911-C-T	6.37227E-05	0.000175377	0	2	2	0	31386	11404	19982	0	0	0	292
21-27098949-A-C	9.55231E-05	0.000262927	0	3	3	0	31406	11410	19996	0	0	0	278
21-27098950-G-C	0.003633582	0.00991402	5.00601E-05	114	113	1	31374	11398	19976	0	0	0	488
21-27098954-T-C	3.18674E-05	8.76885E-05	0	1	1	0	31380	11404	19976	0	0	0	103
21-27098976-T-A	3.18512E-05	0	5.0035E-05	1	0	1	31396	11410	19986	0	0	0	432
21-27099018-G-A	3.1841E-05	8.76424E-05	0	1	1	0	31406	11410	19996	0	0	0	244
21-27099029-G-GT	3.1839E-05	0	5.001E-05	1	0	1	31408	11412	19996	0	0	0	118
21-27099046-A-G	0.063913127	0.026809182	0.085101061	2007	306	1701	31402	11414	19988	81	7	74	321
21-27099054-C-A	9.55597E-05	0.000262927	0	3	3	0	31394	11410	19984	0	0	0	365
21-27099060-T-C	0.000382068	0.000175254	0.0005001	12	2	10	31408	11412	19996	0	0	0	483
21-27099063-T-C	6.36699E-05	0.000175193	0	2	2	0	31412	11416	19996	0	0	0	330
21-27099068-A-G	0.000222902	0.000613282	0	7	7	0	31404	11414	19990	0	0	0	364
21-27099093-T-G	6.36862E-05	0.000175254	0	2	2	0	31404	11412	19992	0	0	0	294
21-27099094-G-A	0.000191083	0.000438059	5.0035E-05	6	5	1	31400	11414	19986	0	0	0	308
21-27099124-A-C	3.1841E-05	8.76578E-05	0	1	1	0	31406	11408	19998	0	0	0	87
21-27099175-A-C	3.1839E-05	8.76271E-05	0	1	1	0	31408	11412	19996	0	0	0	267
21-27099179-A-G	3.18431E-05	8.76424E-05	0	1	1	0	31404	11410	19994	0	0	0	406
21-27099182-CA-C	3.18573E-05	8.76732E-05	0	1	1	0	31390	11406	19984	0	0	0	137
21-27099221-T-C	3.18593E-05	0	5.00501E-05	1	0	1	31388	11408	19980	0	0	0	332
21-27099231-C-T	0.000127405	0	0.00020016	4	0	4	31396	11412	19984	0	0	0	402
21-27099258-C-T	6.37389E-05	0.000175285	0	2	2	0	31378	11410	19968	0	0	0	130
21-27099282-T-C	0.000127332	0	0.0002	4	0	4	31414	11414	20000	0	0	0	3
21-27099287-T-C	3.1835E-05	0	0.00005	1	0	1	31412	11412	20000	0	0	0	365
21-27099304-C-T	0.011338302	0.03104174	0.00010003	356	354	2	31398	11404	19994	9	9	0	136
21-27099310-T-G	0.004616658	0.001402525	0.00645	145	16	129	31408	11408	20000	1	0	1	239
21-27099324-C-T	0.000573468	0.000262973	0.000750751	18	3	15	31388	11408	19980	0	0	0	74
21-27099325-GCT-G	3.1841E-05	8.76424E-05	0	1	1	0	31406	11410	19996	0	0	0	456
21-27099328-CTCTG-C	0.000668705	0.000262973	0.00090018	21	3	18	31404	11408	19996	0	0	0	43
21-27099331-T-C	0.018339277	0.04977217	0.00040008	576	568	8	31408	11412	19996	15	15	0	35
21-27099338-G-A	3.18451E-05	0	5.0035E-05	1	0	1	31402	11416	19986	0	0	0	105
21-27099383-T-C	0.00241992	0.006483266	0.00010004	76	74	2	31406	11414	19992	0	0	0	249
21-27099415-G-C	6.36943E-05	8.76424E-05	5.0025E-05	2	1	1	31400	11410	19990	0	0	0	15
21-27099439-A-T	0.031090724	0.084473684	0.00065026	976	963	13	31392	11400	19992	45	45	0	109
21-27099443-G-A	3.18451E-05	0	5.0025E-05	1	0	1	31402	11412	19990	0	0	0	442
21-27099454-T-G	3.1841E-05	0	5.0015E-05	1	0	1	31406	11412	19994	0	0	0	206
21-27099474-C-T	0.000127372	0.000350508	0	4	4	0	31404	11412	19992	0	0	0	231
21-27099475-G-A	3.18552E-05	0	5.0035E-05	1	0	1	31392	11406	19986	0	0	0	120
21-27099496-G-A	6.36943E-05	0.000175316	0	2	2	0	31400	11408	19992	0	0	0	294
21-27099502-A-C	3.1841E-05	0	5.001E-05	1	0	1	31406	11410	19996	0	0	0	398
21-27099505-T-C	3.1837E-05	8.76271E-05	0	1	1	0	31410	11412	19998	0	0	0	410
21-27099521-A-G	9.55292E-05	0.000262973	0	3	3	0	31404	11408	19996	0	0	0	378
21-27099559-T-C	3.18512E-05	8.76578E-05	0	1	1	0	31396	11408	19988	0	0	0	361
21-27099567-A-C	6.37308E-05	0	0.00010008	2	0	2	31382	11398	19984	0	0	0	457
21-27099585-A-G	3.18532E-05	0	5.0035E-05	1	0	1	31394	11408	19986	0	0	0	3
21-27099602-A-T	6.36902E-05	0.000175285	0	2	2	0	31402	11410	19992	0	0	0	240
21-27099606-A-G	3.18492E-05	0	5.0025E-05	1	0	1	31398	11408	19990	0	0	0	430
21-27099607-C-A	3.18451E-05	8.76578E-05	0	1	1	0	31402	11408	19994	0	0	0	182
21-27099610-C-T	0.000350318	0.000964236	0	11	11	0	31400	11408	19992	0	0	0	89
21-27099621-T-TGTAA	3.18431E-05	8.76271E-05	0	1	1	0	31404	11412	19992	0	0	0	317
21-27099644-C-A	0.031082803	0.084414446	0.00065026	976	963	13	31400	11408	19992	45	45	0	319
21-27099648-T-G	3.1837E-05	0	5.001E-05	1	0	1	31410	11414	19996	0	0	0	179
21-27099684-C-G	0.000191046	0.000525855	0	6	6	0	31406	11410	19996	0	0	0	121
21-27099699-G-A	3.18431E-05	0	5.001E-05	1	0	1	31404	11408	19996	0	0	0	336
21-27099742-T-C	0.000350363	0.000263019	0.0004002	11	3	8	31396	11406	19990	0	0	0	240
21-27099770-T-C	3.1841E-05	8.76732E-05	0	1	1	0	31406	11406	20000	0	0	0	377
21-27099811-A-G	3.18431E-05	8.76271E-05	0	1	1	0	31404	11412	19992	0	0	0	437
21-27099844-G-A	3.18512E-05	0	5.0025E-05	1	0	1	31396	11406	19990	0	0	0	233
21-27099849-A-G	0.001400917	0.003854915	0	44	44	0	31408	11414	19994	0	0	0	386
21-27099865-T-C	3.18492E-05	8.76424E-05	0	1	1	0	31398	11410	19988	0	0	0	410
21-27099867-G-A	3.18492E-05	8.76732E-05	0	1	1	0	31398	11406	19992	0	0	0	370
21-27099908-T-C	3.18512E-05	8.77039E-05	0	1	1	0	31396	11402	19994	0	0	0	8
21-27099923-T-C	3.18512E-05	8.76732E-05	0	1	1	0	31396	11406	19990	0	0	0	72
21-27099929-A-G	0.004142238	0.011315789	5.004E-05	130	129	1	31384	11400	19984	0	0	0	102
21-27099932-C-T	0.000223143	0.000263343	0.00020022	7	3	4	31370	11392	19978	0	0	0	232
21-27099944-C-A	3.18817E-05	8.78117E-05	0	1	1	0	31366	11388	19978	0	0	0	481
21-27099974-C-T	0.000414039	0.001139351	0	13	13	0	31398	11410	19988	0	0	0	352
21-27099977-C-CT	3.18552E-05	0	5.0045E-05	1	0	1	31392	11410	19982	0	0	0	411
21-27099978-T-C	3.18573E-05	8.76578E-05	0	1	1	0	31390	11408	19982	0	0	0	144
21-27100003-G-A	6.37105E-05	0.000175377	0	2	2	0	31392	11404	19988	0	0	0	489
21-27100022-A-T	6.36983E-05	0.000175316	0	2	2	0	31398	11408	19990	0	0	0	47
21-27100036-A-G	3.18471E-05	0	5.002E-05	1	0	1	31400	11408	19992	0	0	0	442
21-27100045-C-A	3.18431E-05	0	5.002E-05	1	0	1	31404	11412	19992	0	0	0	52
21-27100074-C-A	3.18593E-05	8.77039E-05	0	1	1	0	31388	11402	19986	0	0	0	488
21-27100078-C-T	3.18573E-05	8.77039E-05	0	1	1	0	31390	11402	19988	0	0	0	369
21-27100090-A-G	6.37024E-05	0	0.00010005	2	0	2	31396	11406	19990	0	0	0	179
21-27100091-C-T	0.011403453	0.011048755	0.011605803	358	126	232	31394	11404	19990	1	1	0	420
21-27100122-T-C	3.18431E-05	8.76578E-05	0	1	1	0	31404	11408	19996	0	0	0	57
21-27100128-T-C	0.002865877	0.007450912	0.00025005	90	85	5	31404	11408	19996	3	3	0	124
21-27100129-T-A	3.18512E-05	0	5.001E-05	1	0	1	31396	11400	19996	0	0	0	63
21-27100132-C-T	3.18552E-05	0	5.0025E-05	1	0	1	31392	11402	19990	0	0	0	279
21-27100132-CA-C	3.18552E-05	0	5.0025E-05	1	0	1	31392	11402	19990	0	0	0	10
21-27100177-G-A	9.55657E-05	0	0.000150105	3	0	3	31392	11406	19986	0	0	0	497
21-27100181-C-A	3.18532E-05	8.76271E-05	0	1	1	0	31394	11412	19982	0	0	0	367
21-27100182-A-G	0.007230681	0.016564417	0.001901521	227	189	38	31394	11410	19984	0	0	0	39
21-27100191-G-T	0.00140172	0.000964912	0.001650825	44	11	33	31390	11400	19990	0	0	0	418
21-27100215-T-C	0.003630111	0.009996492	0	114	114	0	31404	11404	20000	0	0	0	245
21-27100220-A-G	3.18512E-05	8.77193E-05	0	1	1	0	31396	11400	19996	0	0	0	378
21-27100254-C-T	3.18613E-05	0	5.0025E-05	1	0	1	31386	11396	19990	0	0	0	9
21-27100260-T-C	3.18512E-05	0	5.0025E-05	1	0	1	31396	11406	19990	0	0	0	381
21-27100263-T-C	6.37024E-05	0	0.00010003	2	0	2	31396	11402	19994	0	0	0	236
21-27100274-A-T	3.18613E-05	8.77347E-05	0	1	1	0	31386	11398	19988	0	0	0	499
21-27100307-C-T	0.003441902	0.009472022	0	108	108	0	31378	11402	19976	2	2	0	119
21-27100309-C-T	3.18613E-05	0	5.00501E-05	1	0	1	31386	11406	19980	0	0	0	35
21-27100310-G-A	3.1904E-05	0	5.01303E-05	1	0	1	31344	11396	19948	0	0	0	357
21-27100323-G-C	3.18837E-05	0	5.00902E-05	1	0	1	31364	11400	19964	0	0	0	132
21-27100343-C-T	3.18634E-05	8.76578E-05	0	1	1	0	31384	11408	19976	0	0	0	311
21-27100346-C-T	3.18573E-05	8.76117E-05	0	1	1	0	31390	11414	19976	0	0	0	112
21-27100350-C-T	0.000254826	0.000701016	0	8	8	0	31394	11412	19982	0	0	0	363
21-27100356-A-G	6.37389E-05	8.76578E-05	5.00751E-05	2	1	1	31378	11408	19970	0	0	0	307
21-27100381-G-T	3.18715E-05	0	5.00651E-05	1	0	1	31376	11402	19974	0	0	0	216
21-27100388-A-C	3.18573E-05	0	5.003E-05	1	0	1	31390	11402	19988	0	0	0	289
21-27100396-G-C	6.3743E-05	0.000175469	0	2	2	0	31376	11398	19978	0	0	0	417
21-27100403-T-C	3.18695E-05	0	5.004E-05	1	0	1	31378	11394	19984	0	0	0	492
21-27100426-T-G	3.18552E-05	8.77347E-05	0	1	1	0	31392	11398	19994	0	0	0	384
21-27100439-C-T	0.000414065	0.000175377	0.00055022	13	2	11	31396	11404	19992	0	0	0	397
21-27100468-G-A	0.011345529	0.031063531	0.00010009	356	354	2	31378	11396	19982	9	9	0	140
21-27100474-A-C	3.18573E-05	0	5.0025E-05	1	0	1	31390	11400	19990	0	0	0	149
21-27100480-G-A	3.18552E-05	0	5.002E-05	1	0	1	31392	11400	19992	0	0	0	176
21-27100490-T-C	3.18573E-05	0	5.003E-05	1	0	1	31390	11402	19988	0	0	0	451
21-27100516-C-A	0.000509879	0.000175469	0.000700631	16	2	14	31380	11398	19982	0	0	0	283
21-27100530-T-C	3.18512E-05	0	5.0025E-05	1	0	1	31396	11406	19990	0	0	0	484
21-27100554-C-G	6.36983E-05	0.000175285	0	2	2	0	31398	11410	19988	0	0	0	307
21-27100567-A-T	3.18573E-05	0	5.00551E-05	1	0	1	31390	11412	19978	0	0	0	431
21-27100624-C-T	3.18451E-05	0	5.0025E-05	1	0	1	31402	11412	19990	0	0	0	280
21-27100630-T-C	3.18451E-05	0	5.002E-05	1	0	1	31402	11410	19992	0	0	0	19
21-27100662-C-T	3.18451E-05	8.76424E-05	0	1	1	0	31402	11410	19992	0	0	0	59
21-27100663-A-G	3.18634E-05	0	5.00501E-05	1	0	1	31384	11404	19980	0	0	0	386
21-27100669-T-C	0.001943542	0.005172716	0.0001001	61	59	2	31386	11406	19980	2	2	0	316
21-27100688-C-A	3.18613E-05	8.77347E-05	0	1	1	0	31386	11398	19988	0	0	0	399
21-27100692-A-G	6.37511E-05	0	0.0001001	2	0	2	31372	11392	19980	0	0	0	196
21-27100716-C-A	3.18695E-05	0	5.0035E-05	1	0	1	31378	11392	19986	0	0	0	101
21-27100723-C-T	3.18593E-05	8.76885E-05	0	1	1	0	31388	11404	19984	0	0	0	316
21-27100818-T-C	0.005923944	0.003330996	0.007403702	186	38	148	31398	11408	19990	3	1	2	479
21-27100822-T-G	0.000191083	0.000526039	0	6	6	0	31400	11406	19994	0	0	0	378
21-27100831-C-T	6.36943E-05	0	0.00010002	2	0	2	31400	11404	19996	0	0	0	225
21-27100842-C-T	0.011875955	0.032334385	0.00020004	373	369	4	31408	11412	19996	8	8	0	382
21-27100869-C-T	6.37105E-05	0	0.00010006	2	0	2	31392	11404	19988	0	0	0	29
21-27100894-G-T	0.000191131	0.000525947	0	6	6	0	31392	11408	19984	0	0	0	373
21-27100898-C-A	0.000222916	0.000175254	0.000250125	7	2	5	31402	11412	19990	0	0	0	460
21-27100915-T-C	3.18451E-05	8.76578E-05	0	1	1	0	31402	11408	19994	0	0	0	342
21-27100956-C-T	0.203409309	0.25334507	0.174997496	6372	2878	3494	31326	11360	19966	673	365	308	66
21-27100957-G-GT	3.18654E-05	8.76732E-05	0	1	1	0	31382	11406	19976	0	0	0	400
21-27100990-G-A	3.18593E-05	8.76732E-05	0	1	1	0	31388	11406	19982	0	0	0	105
21-27101019-G-C	6.37064E-05	0	0.00010006	2	0	2	31394	11406	19988	0	0	0	1
21-27101043-A-T	3.18512E-05	8.76271E-05	0	1	1	0	31396	11412	19984	0	0	0	112
21-27101066-G-C	3.18552E-05	8.77039E-05	0	1	1	0	31392	11402	19990	0	0	0	235
21-27101076-T-C	3.18451E-05	0	5.002E-05	1	0	1	31402	11410	19992	0	0	0	409
21-27101106-C-T	3.18492E-05	0	5.003E-05	1	0	1	31398	11410	19988	0	0	0	398
21-27101116-C-T	0.000159266	0.000438289	0	5	5	0	31394	11408	19986	0	0	0	140
21-27101148-T-C	3.20657E-05	0	5.0025E-05	1	0	1	31186	11196	19990	0	0	0	394
21-27101160-TAGA-T	0.041982786	0.114614439	0.00060048	1317	1305	12	31370	11386	19984	99	99	0	50
21-27101166-C-A	0.00082887	0	0.001301041	26	0	26	31368	11384	19984	0	0	0	13
21-27101197-G-T	3.18613E-05	8.76578E-05	0	1	1	0	31386	11408	19978	0	0	0	476
21-27101211-T-C	3.18451E-05	0	5.0025E-05	1	0	1	31402	11412	19990	0	0	0	327
21-27101221-C-T	0.000127397	8.76424E-05	0.00015009	4	1	3	31398	11410	19988	0	0	0	10
21-27101238-CT-C	0.000191046	0.000525578	0	6	6	0	31406	11416	19990	0	0	0	302
21-27101243-C-CAAA	0.000191071	0.000525578	0	6	6	0	31402	11416	19986	0	0	0	281
21-27101253-A-G	3.18451E-05	0	5.0025E-05	1	0	1	31402	11412	19990	0	0	0	418
21-27101255-A-C	3.18492E-05	0	5.0025E-05	1	0	1	31398	11408	19990	0	0	0	13
21-27101259-A-G	0.001719088	0.000350447	0.00250025	54	4	50	31412	11414	19998	0	0	0	99
21-27101260-T-C	3.18431E-05	0	5.002E-05	1	0	1	31404	11412	19992	0	0	0	134
21-27101272-T-C	6.37471E-05	0.000175531	0	2	2	0	31374	11394	19980	0	0	0	73
21-27101272-TG-T	3.18735E-05	8.77655E-05	0	1	1	0	31374	11394	19980	0	0	0	313
21-27101290-C-T	3.30229E-05	0	5.04134E-05	1	0	1	30282	10446	19836	0	0	0	248
21-27101291-G-A	9.98137E-05	0.000292341	0	3	3	0	30056	10262	19794	0	0	0	388
21-27101302-C-G	7.14388E-05	0.000231589	0	2	2	0	27996	8636	19360	0	0	0	447
21-27101313-G-A	3.59919E-05	0	5.17974E-05	1	0	1	27784	8478	19306	0	0	0	52
21-27101314-G-GC	0.287889428	0.484069706	0.176249624	9019	5500	3519	31328	11362	19966	1718	1408	310	422
21-27101320-AC-A	6.36821E-05	0.000175285	0	2	2	0	31406	11410	19996	0	0	0	438
21-27101325-A-C	3.18431E-05	8.76424E-05	0	1	1	0	31404	11410	19994	0	0	0	263
21-27101326-T-A	3.1839E-05	8.76117E-05	0	1	1	0	31408	11414	19994	0	0	0	200
21-27101346-C-G	3.18552E-05	0	5.0045E-05	1	0	1	31392	11410	19982	0	0	0	335
21-27101358-T-C	3.18492E-05	8.76578E-05	0	1	1	0	31398	11408	19990	0	0	0	282
21-27101370-A-G	0.000127429	8.76424E-05	0.00015015	4	1	3	31390	11410	19980	0	0	0	266
21-27101405-A-G	3.18512E-05	0	5.004E-05	1	0	1	31396	11412	19984	0	0	0	4
21-27101424-T-G	0.000254761	0.000701262	0	8	8	0	31402	11408	19994	0	0	0	136
21-27101462-T-C	3.22186E-05	0	5.07563E-05	1	0	1	31038	11336	19702	0	0	0	225
21-27101476-G-A	3.18552E-05	0	5.004E-05	1	0	1	31392	11408	19984	0	0	0	235
21-27101507-C-T	6.37064E-05	0.000175223	0	2	2	0	31394	11414	19980	0	0	0	352
21-27101527-G-A	0.000254858	0.000701631	0	8	8	0	31390	11402	19988	0	0	0	189
21-27101543-T-C	3.18532E-05	8.76578E-05	0	1	1	0	31394	11408	19986	0	0	0	335
21-27101545-G-C	0.000796838	0.002192213	0	25	25	0	31374	11404	19970	0	0	0	29
21-27101556-T-A	0.000191046	0.000525855	0	6	6	0	31406	11410	19996	0	0	0	343
21-27101562-C-A	3.18512E-05	0	5.0035E-05	1	0	1	31396	11410	19986	0	0	0	399
21-27101565-T-C	3.1837E-05	0	5.0005E-05	1	0	1	31410	11412	19998	0	0	0	383
21-27101577-T-C	3.1839E-05	0	5.002E-05	1	0	1	31408	11416	19992	0	0	0	172
21-27101582-G-A	3.18654E-05	8.76732E-05	0	1	1	0	31382	11406	19976	0	0	0	159
21-27101594-T-C	0.000127356	0.000262835	5.0015E-05	4	3	1	31408	11414	19994	0	0	0	91
21-27101627-T-A	0.001114508	0.000175193	0.001650991	35	2	33	31404	11416	19988	0	0	0	327
21-27101644-C-T	3.18715E-05	8.77193E-05	0	1	1	0	31376	11400	19976	0	0	0	442
21-27101649-G-A	0.000127502	0	0.0002003	4	0	4	31372	11402	19970	0	0	0	230
21-27101651-AT-A	3.18593E-05	8.76578E-05	0	1	1	0	31388	11408	19980	0	0	0	125
21-27101666-T-C	0.000127364	0	0.00020006	4	0	4	31406	11412	19994	0	0	0	452
21-27101678-T-C	3.18471E-05	8.76424E-05	0	1	1	0	31400	11410	19990	0	0	0	386
21-27101682-T-C	3.18552E-05	8.76732E-05	0	1	1	0	31392	11406	19986	0	0	0	22
21-27101693-T-G	0.000191095	0	0.00030021	6	0	6	31398	11412	19986	0	0	0	128
21-27101699-T-C	3.18573E-05	8.76424E-05	0	1	1	0	31390	11410	19980	0	0	0	316
21-27101723-A-G	0.00117887	0.000438289	0.001601762	37	5	32	31386	11408	19978	0	0	0	344
21-27101749-T-C	3.18634E-05	0	5.00601E-05	1	0	1	31384	11408	19976	0	0	0	124
21-27101764-T-C	3.18532E-05	0	5.0035E-05	1	0	1	31394	11408	19986	0	0	0	204
21-27101769-T-TA	6.37349E-05	0.000175285	0	2	2	0	31380	11410	19970	0	0	0	356
21-27101783-T-A	0.000286661	0.000262927	0.00030021	9	3	6	31396	11410	19986	0	0	0	446
21-27101786-T-C	3.18451E-05	8.76424E-05	0	1	1	0	31402	11410	19992	0	0	0	287
21-27101798-T-C	0.002037827	0.000876424	0.00270054	64	10	54	31406	11410	19996	0	0	0	45
21-27101801-AG-A	3.19959E-05	8.78426E-05	0	1	1	0	31254	11384	19870	0	0	0	343
21-27101853-C-G	6.37308E-05	0	0.00010006	2	0	2	31382	11394	19988	0	0	0	262
21-27101881-C-T	3.31587E-05	9.59877E-05	0	1	1	0	30158	10418	19740	0	0	0	311
21-27101898-AC-A	3.49089E-05	0.00010686	0	1	1	0	28646	9358	19288	0	0	0	335
21-27101899-CT-C	0.25695952	0.399982407	0.175486069	8049	4547	3502	31324	11368	19956	1241	937	304	34
21-27101900-T-A	3.19448E-05	8.80437E-05	0	1	1	0	31304	11358	19946	0	0	0	449
21-27101925-GTTAT-G	3.18613E-05	8.76732E-05	0	1	1	0	31386	11406	19980	0	0	0	466
21-27101939-T-C	3.18471E-05	0	5.0025E-05	1	0	1	31400	11410	19990	0	0	0	254
21-27101965-A-C	3.18512E-05	8.76732E-05	0	1	1	0	31396	11406	19990	0	0	0	424
21-27101986-C-T	3.18471E-05	0	5.002E-05	1	0	1	31400	11408	19992	0	0	0	417
21-27101993-G-A	3.18492E-05	0	5.003E-05	1	0	1	31398	11410	19988	0	0	0	134
21-27102006-T-C	3.18451E-05	8.76424E-05	0	1	1	0	31402	11410	19992	0	0	0	339
21-27102014-G-C	0.008217084	0.022532001	5.002E-05	258	257	1	31398	11406	19992	4	4	0	64
21-27102026-A-G	0.000286551	0	0.000450135	9	0	9	31408	11414	19994	0	0	0	285
21-27102041-C-T	3.18492E-05	8.76271E-05	0	1	1	0	31398	11412	19986	0	0	0	294
21-27102042-G-A	0.000222958	0.000175223	0.000250225	7	2	5	31396	11414	19982	0	0	0	111
21-27102057-C-T	3.1839E-05	0	5.001E-05	1	0	1	31408	11412	19996	0	0	0	101
21-27102104-ATGCTGATTC-A	6.36862E-05	0	0.00010004	2	0	2	31404	11412	19992	0	0	0	391
21-27102173-T-C	0.030963303	0.084137568	0.000650195	972	959	13	31392	11398	19994	43	43	0	162
21-27102180-A-G	0.005349978	0.01429323	0.000250025	168	163	5	31402	11404	19998	2	2	0	424
21-27102188-A-G	3.1841E-05	8.76424E-05	0	1	1	0	31406	11410	19996	0	0	0	185
21-27102211-ACAT-A	0.000700414	0	0.00110011	22	0	22	31410	11412	19998	0	0	0	423
21-27102216-A-T	3.18451E-05	8.76271E-05	0	1	1	0	31402	11412	19990	0	0	0	312
21-27102243-A-G	3.18492E-05	0	5.003E-05	1	0	1	31398	11410	19988	0	0	0	153
21-27102247-T-C	3.18512E-05	0	5.002E-05	1	0	1	31396	11404	19992	0	0	0	285
21-27102253-TCTC-T	3.1841E-05	0	5.0025E-05	1	0	1	31406	11416	19990	0	0	0	69
21-27102285-G-A	3.18593E-05	8.76732E-05	0	1	1	0	31388	11406	19982	0	0	0	415
21-27102301-C-T	3.18492E-05	8.76578E-05	0	1	1	0	31398	11408	19990	0	0	0	479
21-27102306-G-C	6.36983E-05	0.000175377	0	2	2	0	31398	11404	19994	0	0	0	449
21-27102312-T-C	3.18552E-05	8.76885E-05	0	1	1	0	31392	11404	19988	0	0	0	476
21-27102364-T-C	3.18634E-05	8.76885E-05	0	1	1	0	31384	11404	19980	0	0	0	190
21-27102375-G-A	0.000382093	0	0.00060018	12	0	12	31406	11412	19994	0	0	0	192
21-27102399-T-C	9.55597E-05	0	0.00015009	3	0	3	31394	11406	19988	0	0	0	210
21-27102417-A-G	3.18471E-05	0	5.0015E-05	1	0	1	31400	11406	19994	0	0	0	148
21-27102425-T-A	3.18634E-05	8.77347E-05	0	1	1	0	31384	11398	19986	0	0	0	236
21-27102425-T-C	6.37267E-05	0.000175469	0	2	2	0	31384	11398	19986	0	0	0	207
21-27102430-T-G	6.36983E-05	0.000175316	0	2	2	0	31398	11408	19990	0	0	0	57
21-27102433-T-C	0.029473617	0.08011583	0.00060036	925	913	12	31384	11396	19988	39	39	0	7
21-27102435-C-T	3.18532E-05	8.77039E-05	0	1	1	0	31394	11402	19992	0	0	0	190
21-27102446-G-A	3.18552E-05	8.76885E-05	0	1	1	0	31392	11404	19988	0	0	0	318
21-27102479-C-CA	3.18431E-05	0	5.002E-05	1	0	1	31404	11412	19992	0	0	0	431
21-27102483-T-C	3.18431E-05	8.76578E-05	0	1	1	0	31404	11408	19996	0	0	0	165
21-27102491-G-C	9.55475E-05	0.000263112	0	3	3	0	31398	11402	19996	0	0	0	172
21-27102508-C-T	3.18471E-05	8.76424E-05	0	1	1	0	31400	11410	19990	0	0	0	258
21-27102517-C-T	9.55231E-05	0	0.00015006	3	0	3	31406	11414	19992	0	0	0	428
21-27102520-C-T	3.1837E-05	8.76117E-05	0	1	1	0	31410	11414	19996	0	0	0	465
21-27102535-T-G	3.18532E-05	8.76732E-05	0	1	1	0	31394	11406	19988	0	0	0	404
21-27102553-G-A	3.18492E-05	8.76424E-05	0	1	1	0	31398	11410	19988	0	0	0	176
21-27102566-G-C	0.000477768	8.76271E-05	0.00070056	15	1	14	31396	11412	19984	0	0	0	273
21-27102571-T-C	3.18512E-05	0	5.002E-05	1	0	1	31396	11404	19992	0	0	0	284
21-27102603-G-A	6.37024E-05	0.000175254	0	2	2	0	31396	11412	19984	0	0	0	367
21-27102604-T-C	3.18715E-05	8.76578E-05	0	1	1	0	31376	11408	19968	0	0	0	117
21-27102636-A-C	3.18451E-05	8.76424E-05	0	1	1	0	31402	11410	19992	0	0	0	313
21-27102674-A-AT	9.55292E-05	8.76271E-05	0.00010004	3	1	2	31404	11412	19992	0	0	0	336
21-27102675-C-T	9.5584E-05	8.76732E-05	0.0001001	3	1	2	31386	11406	19980	0	0	0	304
21-27102689-C-T	3.18898E-05	0	5.01002E-05	1	0	1	31358	11398	19960	0	0	0	241
21-27102690-G-A	9.56206E-05	0.000175316	5.00851E-05	3	2	1	31374	11408	19966	0	0	0	5
21-27102692-C-T	0.00239021	0.000613712	0.003404767	75	7	68	31378	11406	19972	0	0	0	266
21-27102702-T-C	0.042373963	0.115539947	0.000601504	1328	1316	12	31340	11390	19950	104	104	0	358
21-27102722-T-G	3.20349E-05	8.80282E-05	0	1	1	0	31216	11360	19856	0	0	0	210
21-27102733-G-C	3.18776E-05	0	5.00851E-05	1	0	1	31370	11404	19966	0	0	0	174
21-27102758-C-T	3.19203E-05	0	5.01706E-05	1	0	1	31328	11396	19932	0	0	0	41
21-27102767-A-G	0.288278505	0.484797891	0.176066232	9026	5517	3509	31310	11380	19930	1730	1420	310	421
21-27102783-G-A	9.58222E-05	0.000263019	0	3	3	0	31308	11406	19902	0	0	0	428
21-27102806-A-C	3.19163E-05	0	5.01655E-05	1	0	1	31332	11398	19934	0	0	0	449
21-27102829-G-A	3.19795E-05	8.78426E-05	0	1	1	0	31270	11384	19886	0	0	0	173
21-27102836-G-C	0.000256246	0.000702988	0	8	8	0	31220	11380	19840	0	0	0	406
21-27102855-A-T	6.40697E-05	0.000176025	0	2	2	0	31216	11362	19854	0	0	0	125
21-27102905-C-T	0.00676071	0.018201096	0.000102838	208	206	2	30766	11318	19448	1	1	0	1
21-27102906-G-A	3.25478E-05	8.84956E-05	0	1	1	0	30724	11300	19424	0	0	0	380
21-27102913-C-T	0.000195262	0.000443105	5.14297E-05	6	5	1	30728	11284	19444	0	0	0	423
21-27102916-A-G	9.6718E-05	0.00026441	0	3	3	0	31018	11346	19672	0	0	0	352
21-27102958-T-C	9.8925E-05	8.95255E-05	0.000104406	3	1	2	30326	11170	19156	0	0	0	267
21-27102970-A-G	0.001116878	0.000446429	0.00150712	34	5	29	30442	11200	19242	0	0	0	257
21-27103009-C-A	3.67755E-05	9.52018E-05	0	1	1	0	27192	10504	16688	0	0	0	389
21-27103018-C-A	4.0843E-05	0	6.81199E-05	1	0	1	24484	9804	14680	0	0	0	258
21-27103037-C-T	7.04225E-05	0	0.000126775	1	0	1	14200	6312	7888	0	0	0	106
21-27103041-G-A	0.001038884	0.001911524	0	7	7	0	6738	3662	3076	0	0	0	160
21-27103045-CACAAAAAAAAAAAAAAAAAAAAA-C	0.000675676	0.001014199	0	1	1	0	1480	986	494	0	0	0	368
21-27103046-A-C	0.012854239	0.039502967	0.00017646	215	213	2	16726	5392	11334	5	5	0	460
21-27103049-A-AC	0.060383387	0.06272482	0.059093162	756	279	477	12520	4448	8072	4	4	0	473
21-27103049-A-C	0.000159744	0	0.00024777	2	0	2	12520	4448	8072	0	0	0	193
21-27103062-A-C	0.002957122	0.007714435	7.91014E-05	60	59	1	20290	7648	12642	0	0	0	469
21-27103069-A-C	3.81767E-05	9.52018E-05	0	1	1	0	26194	10504	15690	0	0	0	425
21-27103072-A-C	3.87537E-05	9.85028E-05	0	1	1	0	25804	10152	15652	0	0	0	291
21-27103107-C-A	0.001293613	0.003249857	6.02627E-05	35	34	1	27056	10462	16594	0	0	0	402
21-27103121-A-G	6.53637E-05	0.000177085	0	2	2	0	30598	11294	19304	0	0	0	486
21-27103152-T-C	6.41972E-05	0.000175716	0	2	2	0	31154	11382	19772	0	0	0	435
21-27103165-C-T	0.000224575	0.000615872	0	7	7	0	31170	11366	19804	0	0	0	26
21-27103219-C-T	3.19163E-05	0	5.01907E-05	1	0	1	31332	11408	19924	0	0	0	350
21-27103234-T-A	0.031200051	0.084681674	0.000652938	976	963	13	31282	11372	19910	45	45	0	156
21-27103253-T-C	3.19428E-05	8.77809E-05	0	1	1	0	31306	11392	19914	0	0	0	349
21-27103283-C-T	6.3804E-05	0.0001755	0	2	2	0	31346	11396	19950	0	0	0	421
21-27103285-G-GTGGCTCA	3.18776E-05	0	5.00751E-05	1	0	1	31370	11400	19970	0	0	0	217
21-27103292-ATGTG-A	3.18776E-05	8.77347E-05	0	1	1	0	31370	11398	19972	0	0	0	416
21-27103293-T-C	0.000318898	0	0.000500952	10	0	10	31358	11396	19962	0	0	0	176
21-27103317-C-A	3.19264E-05	8.78117E-05	0	1	1	0	31322	11388	19934	0	0	0	107
21-27103323-C-T	6.37592E-05	0.000175285	0	2	2	0	31368	11410	19958	0	0	0	60
21-27103349-T-A	3.18715E-05	0	5.00651E-05	1	0	1	31376	11402	19974	0	0	0	322
21-27103365-C-CA	0.000350832	0.000175377	0.000451128	11	2	9	31354	11404	19950	0	0	0	71
21-27103382-GT-G	0.000287118	0.000790028	0	9	9	0	31346	11392	19954	0	0	0	189
21-27103384-C-A	3.19163E-05	0	5.01303E-05	1	0	1	31332	11384	19948	0	0	0	246
21-27103403-A-G	3.19061E-05	8.77963E-05	0	1	1	0	31342	11390	19952	0	0	0	482
21-27103413-C-A	3.19203E-05	8.77655E-05	0	1	1	0	31328	11394	19934	0	0	0	447
21-27103413-C-T	3.19203E-05	0	5.01655E-05	1	0	1	31328	11394	19934	0	0	0	317
21-27103415-T-C	6.37836E-05	0	0.00010022	2	0	2	31356	11400	19956	0	0	0	417
21-27103422-G-A	0.000159418	0.000350693	5.01052E-05	5	4	1	31364	11406	19958	0	0	0	28
21-27103424-G-A	0.257605841	0.400405787	0.176219206	8044	4539	3505	31226	11336	19890	1249	942	307	305
21-27103427-C-A	3.18695E-05	8.77193E-05	0	1	1	0	31378	11400	19978	0	0	0	5
21-27103444-T-C	0.000286935	0.000789474	0	9	9	0	31366	11400	19966	0	0	0	203
21-27103463-G-C	0.006661142	0.018148343	0.00010015	209	207	2	31376	11406	19970	1	1	0	450
21-27103484-C-T	9.56877E-05	8.77809E-05	0.0001002	3	1	2	31352	11392	19960	0	0	0	378
21-27103485-G-A	6.38244E-05	8.78426E-05	5.01203E-05	2	1	1	31336	11384	19952	0	0	0	103
21-27103524-G-T	3.18674E-05	8.76732E-05	0	1	1	0	31380	11406	19974	0	0	0	379
21-27103525-C-T	3.18735E-05	0	5.00851E-05	1	0	1	31374	11408	19966	0	0	0	347
21-27103530-AT-A	3.18674E-05	0	5.00551E-05	1	0	1	31380	11402	19978	0	0	0	380
21-27103541-G-T	3.18898E-05	8.77039E-05	0	1	1	0	31358	11402	19956	0	0	0	315
21-27103542-ACT-A	3.1902E-05	8.77039E-05	0	1	1	0	31346	11402	19944	0	0	0	295
21-27103571-T-G	0.001116712	0.002897787	0.000100231	35	33	2	31342	11388	19954	0	0	0	16
21-27103587-T-C	3.18817E-05	0	5.00952E-05	1	0	1	31366	11404	19962	0	0	0	282
21-27103614-C-T	0.344446573	0.163417633	0.447907257	10786	1861	8925	31314	11388	19926	2246	217	2029	77
21-27103623-G-T	0.004717282	0.012887954	5.00801E-05	148	147	1	31374	11406	19968	2	2	0	187
21-27103626-G-A	0.000637796	0.001755002	0	20	20	0	31358	11396	19962	0	0	0	111
21-27103626-G-T	3.18898E-05	8.77501E-05	0	1	1	0	31358	11396	19962	0	0	0	360
21-27103628-G-A	3.18573E-05	0	5.0045E-05	1	0	1	31390	11408	19982	0	0	0	402
21-27103634-A-T	3.18573E-05	8.76424E-05	0	1	1	0	31390	11410	19980	0	0	0	309
21-27103644-G-A	3.18837E-05	8.77347E-05	0	1	1	0	31364	11398	19966	0	0	0	358
21-27103668-C-T	0.000318979	0.000789889	5.01102E-05	10	9	1	31350	11394	19956	0	0	0	476
21-27103669-G-A	3.1904E-05	8.77963E-05	0	1	1	0	31344	11390	19954	0	0	0	254
21-27103717-CT-C	0.999024686	0.999635635	0.998667093	29705	10974	18731	29734	10978	18756	14838	5485	9353	17
21-27103721-T-G	3.19918E-05	8.79198E-05	0	1	1	0	31258	11374	19884	0	0	0	105
21-27103762-C-T	3.20821E-05	0	5.03728E-05	1	0	1	31170	11318	19852	0	0	0	312
21-27103764-C-T	0.000385159	0.001058201	0	12	12	0	31156	11340	19816	0	0	0	358
21-27103778-C-T	0.009876227	0.026079295	0.000604961	308	296	12	31186	11350	19836	5	5	0	483
21-27103787-C-T	0.011269505	0.030748899	0.000101031	351	349	2	31146	11350	19796	8	8	0	491
21-27103788-T-A	6.43004E-05	0.000176523	0	2	2	0	31104	11330	19774	0	0	0	86
21-27103793-T-C	6.43252E-05	0	0.000101276	2	0	2	31092	11344	19748	0	0	0	33
21-27103796-T-G	3.22186E-05	8.83704E-05	0	1	1	0	31038	11316	19722	0	0	0	128
21-27103806-C-A	6.42013E-05	8.81368E-05	5.04898E-05	2	1	1	31152	11346	19806	0	0	0	142
21-27103824-T-C	6.47249E-05	0.000177242	0	2	2	0	30900	11284	19616	0	0	0	20
21-27103857-G-C	6.46329E-05	0.000177431	0	2	2	0	30944	11272	19672	0	0	0	194
21-27103869-C-CT	0.01037706	0.004901961	0.013965382	262	49	213	25248	9996	15252	0	0	0	266
21-27103869-C-CTT	0.000118821	0	0.000196696	3	0	3	25248	9996	15252	0	0	0	354
21-27103869-CT-C	0.012159379	0.016306523	0.009441385	307	163	144	25248	9996	15252	6	6	0	426
21-27103869-CTT-C	0.000633714	0.00060024	0.000655652	16	6	10	25248	9996	15252	0	0	0	133
21-27103872-T-C	3.32867E-05	8.98311E-05	0	1	1	0	30042	11132	18910	0	0	0	188
21-27103875-T-A	3.2352E-05	8.84643E-05	0	1	1	0	30910	11304	19606	0	0	0	152
21-27103887-A-G	0.025892179	0.06606724	0.000372486	682	676	6	26340	10232	16108	28	28	0	188
21-27103896-G-A	3.30251E-05	8.99766E-05	0	1	1	0	30280	11114	19166	0	0	0	423
21-27103898-C-G	0.000504066	9.09422E-05	0.000746189	15	1	14	29758	10996	18762	0	0	0	284
21-27103920-T-C	3.29142E-05	0	5.16476E-05	1	0	1	30382	11020	19362	0	0	0	298
21-27103932-AT-A	0.094017927	0.112555654	0.083375933	2895	1264	1631	30792	11230	19562	143	72	71	147
21-27103988-CTAATA-C	0.000414832	0.001053001	5.01454E-05	13	12	1	31338	11396	19942	0	0	0	282
21-27103994-GCAATA-G	0.000414885	0.001053741	5.01354E-05	13	12	1	31334	11388	19946	0	0	0	26
21-27104000-C-G	0.000414567	0.001053371	5.00851E-05	13	12	1	31358	11392	19966	0	0	0	145
21-27104009-T-A	3.18756E-05	0	5.00851E-05	1	0	1	31372	11406	19966	0	0	0	410
21-27104021-C-T	0.042171749	0.11513447	0.000600901	1322	1310	12	31348	11378	19970	104	104	0	24
21-27104022-G-A	0.000350922	8.78426E-05	0.000500952	11	1	10	31346	11384	19962	0	0	0	452
21-27104030-A-G	0.011346252	0.03104174	0.00010014	356	354	2	31376	11404	19972	9	9	0	32
21-27104031-C-T	6.37308E-05	8.77193E-05	5.0045E-05	2	1	1	31382	11400	19982	0	0	0	344
21-27104068-T-C	3.19101E-05	8.77963E-05	0	1	1	0	31338	11390	19948	0	0	0	294
21-27104089-T-C	0.008909184	0.006239016	0.010433387	279	71	208	31316	11380	19936	4	1	3	16
21-27104101-A-G	3.19061E-05	8.77347E-05	0	1	1	0	31342	11398	19944	0	0	0	382
21-27104116-C-T	3.19142E-05	8.78117E-05	0	1	1	0	31334	11388	19946	0	0	0	299
21-27104121-C-T	3.19183E-05	0	5.01454E-05	1	0	1	31330	11388	19942	0	0	0	43
21-27104122-G-A	6.37552E-05	8.76732E-05	5.00902E-05	2	1	1	31370	11406	19964	0	0	0	134
21-27104168-G-A	3.18573E-05	0	5.0035E-05	1	0	1	31390	11404	19986	0	0	0	152
21-27104174-T-C	0.012586031	0.034216529	0.000250175	395	390	5	31384	11398	19986	8	8	0	342
21-27104176-G-A	3.19E-05	8.78889E-05	0	1	1	0	31348	11378	19970	0	0	0	500
21-27104225-G-A	3.18837E-05	8.77193E-05	0	1	1	0	31364	11400	19964	0	0	0	262
21-27104230-T-TA	9.56511E-05	8.77193E-05	0.00010018	3	1	2	31364	11400	19964	0	0	0	122
21-27104233-A-C	0.000191168	0.000525947	0	6	6	0	31386	11408	19978	0	0	0	184
21-27104256-T-C	9.55536E-05	0.000262973	0	3	3	0	31396	11408	19988	0	0	0	127
21-27104257-G-A	3.18674E-05	0	5.00651E-05	1	0	1	31380	11406	19974	0	0	0	103
21-27104259-CTTCA-C	3.18593E-05	0	5.004E-05	1	0	1	31388	11404	19984	0	0	0	145
21-27104278-A-T	9.56328E-05	0.000263066	0	3	3	0	31370	11404	19966	0	0	0	107
21-27104298-T-C	3.18492E-05	0	5.0025E-05	1	0	1	31398	11408	19990	0	0	0	148
21-27104309-T-C	6.36983E-05	0	0.00010006	2	0	2	31398	11410	19988	0	0	0	367
21-27104315-CAA-C	3.18552E-05	0	5.004E-05	1	0	1	31392	11408	19984	0	0	0	340
21-27104324-C-T	9.55536E-05	0.000262927	0	3	3	0	31396	11410	19986	0	0	0	239
21-27104327-C-T	6.36943E-05	0.000175254	0	2	2	0	31400	11412	19988	0	0	0	207
21-27104346-G-A	0.000382093	0.00105134	0	12	12	0	31406	11414	19992	0	0	0	315
21-27104362-G-A	3.18492E-05	0	5.0025E-05	1	0	1	31398	11408	19990	0	0	0	103
21-27104364-G-A	3.18573E-05	8.77039E-05	0	1	1	0	31390	11402	19988	0	0	0	176
21-27104388-C-G	3.18634E-05	8.77193E-05	0	1	1	0	31384	11400	19984	0	0	0	70
21-27104397-C-A	0.009494074	0.02578495	0.00020014	298	294	4	31388	11402	19986	4	4	0	334
21-27104404-T-C	3.18654E-05	0	5.004E-05	1	0	1	31382	11398	19984	0	0	0	144
21-27104410-T-C	0.000446201	8.76885E-05	0.000650911	14	1	13	31376	11404	19972	0	0	0	338
21-27104421-T-C	0.000191375	0.000351185	0.00010019	6	4	2	31352	11390	19962	0	0	0	55
21-27104431-G-C	3.18756E-05	0	5.003E-05	1	0	1	31372	11384	19988	0	0	0	330
21-27104464-C-T	0.011834131	0.032209935	0.000200441	371	367	4	31350	11394	19956	8	8	0	307
21-27104494-TG-T	3.18634E-05	8.76424E-05	0	1	1	0	31384	11410	19974	0	0	0	34
21-27104511-G-T	0.009525933	0.025859046	0.0002002	299	295	4	31388	11408	19980	4	4	0	297
21-27104513-G-C	3.18674E-05	0	5.00601E-05	1	0	1	31380	11404	19976	0	0	0	31
21-27104521-C-G	0.031032945	0.084253901	0.000650651	974	961	13	31386	11406	19980	44	44	0	260
21-27104522-TTA-T	3.18674E-05	0	5.00751E-05	1	0	1	31380	11410	19970	0	0	0	371
21-27104527-A-C	3.18512E-05	0	5.004E-05	1	0	1	31396	11412	19984	0	0	0	245
21-27104529-G-T	3.18573E-05	8.76271E-05	0	1	1	0	31390	11412	19978	0	0	0	324
21-27104532-TACAAA-T	3.18898E-05	0	5.01153E-05	1	0	1	31358	11404	19954	0	0	0	374
21-27104537-A-ATTG	3.18552E-05	0	5.0045E-05	1	0	1	31392	11410	19982	0	0	0	200
21-27104560-A-G	0.000127421	0	0.00020018	4	0	4	31392	11410	19982	0	0	0	46
21-27104560-A-T	0.010289246	0.028220859	5.0045E-05	323	322	1	31392	11410	19982	2	2	0	240
21-27104569-A-AT	3.18552E-05	8.76117E-05	0	1	1	0	31392	11414	19978	0	0	0	436
21-27104582-C-T	3.18695E-05	8.76578E-05	0	1	1	0	31378	11408	19970	0	0	0	452
21-27104641-T-A	3.18817E-05	0	5.01002E-05	1	0	1	31366	11406	19960	0	0	0	115
21-27104643-G-A	3.18918E-05	8.77193E-05	0	1	1	0	31356	11400	19956	0	0	0	194
21-27104646-T-C	6.37796E-05	0	0.00010022	2	0	2	31358	11402	19956	0	0	0	422
21-27104653-A-C	3.18939E-05	0	5.01203E-05	1	0	1	31354	11402	19952	0	0	0	437
21-27104654-T-C	0.00012791	0	0.000200985	4	0	4	31272	11370	19902	0	0	0	416
21-27104663-G-T	3.19428E-05	8.79507E-05	0	1	1	0	31306	11370	19936	0	0	0	56
21-27104674-T-A	0.000128033	0	0.000201207	4	0	4	31242	11362	19880	0	0	0	395
21-27104688-C-T	0.00629456	0.01730226	0	196	196	0	31138	11328	19810	2	2	0	4
21-27104715-T-C	3.20082E-05	8.78272E-05	0	1	1	0	31242	11386	19856	0	0	0	340
21-27104720-G-T	3.21419E-05	8.83392E-05	0	1	1	0	31112	11320	19792	0	0	0	418
21-27104734-G-A	0.000353266	0.000969847	0	11	11	0	31138	11342	19796	0	0	0	260
21-27104743-A-G	3.21337E-05	0	5.05919E-05	1	0	1	31120	11354	19766	0	0	0	394
21-27104749-G-A	6.43211E-05	0	0.000101225	2	0	2	31094	11336	19758	0	0	0	253
21-27104777-G-A	6.49182E-05	0.000177683	0	2	2	0	30808	11256	19552	0	0	0	226
21-27104808-A-G	3.24338E-05	0	5.11928E-05	1	0	1	30832	11298	19534	0	0	0	220
21-27104820-G-A	3.27182E-05	8.90155E-05	0	1	1	0	30564	11234	19330	0	0	0	479
21-27104843-G-A	3.28343E-05	0	5.19913E-05	1	0	1	30456	11222	19234	0	0	0	389
21-27104900-T-C	0.000103128	0.000275887	0	3	3	0	29090	10874	18216	0	0	0	66
21-27104910-T-C	3.35616E-05	9.0009E-05	0	1	1	0	29796	11110	18686	0	0	0	307
21-27104922-A-G	3.33823E-05	0	5.32085E-05	1	0	1	29956	11162	18794	0	0	0	44
21-27104927-A-C	3.35211E-05	0	5.34474E-05	1	0	1	29832	11122	18710	0	0	0	266
21-27104945-A-C	0.00222387	0.004955848	0.000592034	66	55	11	29678	11098	18580	1	1	0	93
21-27104948-C-A	0.000141223	0	0.000228728	4	0	4	28324	10836	17488	0	0	0	312
21-27104956-C-A	0.000417973	0.000244021	0.000548246	8	2	6	19140	8196	10944	0	0	0	347
21-27104956-C-CA	0.001776385	0.001464129	0.002010234	34	12	22	19140	8196	10944	0	0	0	18
21-27104956-C-CAA	0.023615465	0.009638848	0.034082602	452	79	373	19140	8196	10944	0	0	0	141
21-27104956-CA-C	0.002664577	0.001220107	0.003746345	51	10	41	19140	8196	10944	0	0	0	123
21-27104956-CAA-C	0.027638454	0.056857003	0.005756579	529	466	63	19140	8196	10944	11	11	0	140
21-27104956-CAAA-C	0.00015674	0.000122011	0.000182749	3	1	2	19140	8196	10944	0	0	0	108
21-27104961-A-G	3.29359E-05	8.87784E-05	0	1	1	0	30362	11264	19098	0	0	0	113
21-27104968-A-G	6.55738E-05	0	0.000103961	2	0	2	30500	11262	19238	0	0	0	326
21-27104968-AAAAGAAAGAAAGAAATCCTAC-A	3.27869E-05	0	5.19805E-05	1	0	1	30500	11262	19238	0	0	0	311
21-27105002-C-A	0.001213592	0.003256151	0	36	36	0	29664	11056	18608	0	0	0	408
21-27105017-CTGTAATCCCAGCACTTTGT-C	3.26073E-05	8.84956E-05	0	1	1	0	30668	11300	19368	0	0	0	69
21-27105025-C-T	0.004030672	0.002045899	0.005188337	123	23	100	30516	11242	19274	1	0	1	340
21-27105048-C-T	3.24086E-05	8.82924E-05	0	1	1	0	30856	11326	19530	0	0	0	47
21-27105063-A-G	3.22269E-05	8.80282E-05	0	1	1	0	31030	11360	19670	0	0	0	252
21-27105069-G-A	9.74596E-05	0.000265111	0	3	3	0	30782	11316	19466	0	0	0	268
21-27105084-T-C	3.27847E-05	0	5.19427E-05	1	0	1	30502	11250	19252	0	0	0	103
21-27105102-C-T	6.48719E-05	8.85583E-05	5.11823E-05	2	1	1	30830	11292	19538	0	0	0	86
21-27105137-A-G	3.25013E-05	0	5.134E-05	1	0	1	30768	11290	19478	0	0	0	275
21-27105140-C-T	3.30819E-05	0	5.24329E-05	1	0	1	30228	11156	19072	0	0	0	20
21-27105144-A-G	0.005452171	0.002309879	0.007277795	167	26	141	30630	11256	19374	0	0	0	206
21-27105187-A-G	0.000164495	0.000447147	0	5	5	0	30396	11182	19214	0	0	0	385
21-27105199-C-T	0.00754667	0.001431639	0.011136793	228	16	212	30212	11176	19036	2	0	2	262
21-27105211-T-C	3.3695E-05	9.09422E-05	0	1	1	0	29678	10996	18682	0	0	0	156
21-27105215-C-T	3.37724E-05	9.09753E-05	0	1	1	0	29610	10992	18618	0	0	0	197
21-27105221-A-G	0.000168294	0	0.000267551	5	0	5	29710	11022	18688	0	0	0	293
21-27105222-G-A	0.000546747	0.001371115	5.45732E-05	16	15	1	29264	10940	18324	0	0	0	19
21-27105234-G-A	3.55644E-05	9.33532E-05	0	1	1	0	28118	10712	17406	0	0	0	313
21-27105248-G-C	0.000112663	0.000292341	0	3	3	0	26628	10262	16366	0	0	0	99
21-27105248-G-T	0.086487907	0.08809199	0.085482097	2303	904	1399	26628	10262	16366	139	91	48	179
21-27105250-G-A	0.0925055	0.110327258	0.08125	2439	1126	1313	26366	10206	16160	127	70	57	236
21-27105250-G-C	7.58553E-05	0.000195963	0	2	2	0	26366	10206	16160	0	0	0	195
21-27105263-T-A	0.003632813	0.008912295	0.000317945	93	88	5	25600	9874	15726	0	0	0	489
21-27105287-ACT-A	4.68604E-05	0	7.4228E-05	1	0	1	21340	7868	13472	0	0	0	322
21-27105290-C-G	0.00014839	0	0.00024667	2	0	2	13478	5370	8108	0	0	0	23
21-27105293-T-C	0.000129333	0.000345304	0	1	1	0	7732	2896	4836	0	0	0	386
21-27105305-A-AAG	7.0492E-05	0.00018315	0	2	2	0	28372	10920	17452	0	0	0	26
21-27105315-A-AAG	3.4002E-05	0	5.45792E-05	1	0	1	29410	11088	18322	0	0	0	38
21-27105315-A-G	0.000238014	0.000631313	0	7	7	0	29410	11088	18322	0	0	0	185
21-27105317-A-AC	3.37655E-05	0	5.41126E-05	1	0	1	29616	11136	18480	0	0	0	25
21-27105339-A-G	0.000228698	0	0.000361608	7	0	7	30608	11250	19358	1	0	1	244
21-27105358-C-G	0.000101331	0.000275786	0	3	3	0	29606	10878	18728	1	1	0	86
21-27105361-C-T	3.33222E-05	0	5.26815E-05	1	0	1	30010	11028	18982	0	0	0	314
21-27105373-T-A	3.41693E-05	0	5.42005E-05	1	0	1	29266	10816	18450	0	0	0	145
21-27105380-A-T	0.000320225	0.000880282	0	10	10	0	31228	11360	19868	0	0	0	421
21-27105383-CTGTT-C	0.000100073	0.000271444	0	3	3	0	29978	11052	18926	0	0	0	175
21-27105388-T-C	0.002346965	0.006448763	0	73	73	0	31104	11320	19784	1	1	0	112
21-27105401-G-T	3.33912E-05	0	5.24659E-05	1	0	1	29948	10888	19060	0	0	0	21
21-27105411-CAT-C	0.001255877	0.003272599	0.000101276	39	37	2	31054	11306	19748	0	0	0	322
21-27105444-C-T	3.19611E-05	0	5.01907E-05	1	0	1	31288	11364	19924	0	0	0	497
21-27105455-G-C	3.19081E-05	0	5.01253E-05	1	0	1	31340	11390	19950	0	0	0	27
21-27105467-C-T	3.19468E-05	0	5.01857E-05	1	0	1	31302	11376	19926	0	0	0	305
21-27105470-CA-C	6.38651E-05	0	0.000100371	2	0	2	31316	11390	19926	0	0	0	291
21-27105497-C-T	3.19693E-05	8.79817E-05	0	1	1	0	31280	11366	19914	0	0	0	339
21-27105504-T-C	3.19346E-05	0	5.01454E-05	1	0	1	31314	11372	19942	0	0	0	408
21-27105509-C-G	3.1953E-05	0	5.02109E-05	1	0	1	31296	11380	19916	0	0	0	133
21-27105513-T-C	3.19101E-05	8.77809E-05	0	1	1	0	31338	11392	19946	0	0	0	33
21-27105515-T-C	3.19326E-05	8.78889E-05	0	1	1	0	31316	11378	19938	0	0	0	277
21-27105521-C-T	3.19489E-05	8.79817E-05	0	1	1	0	31300	11366	19934	0	0	0	74
21-27105563-G-A	0.000223614	0.000263574	0.000200783	7	3	4	31304	11382	19922	0	0	0	377
21-27105581-T-C	3.19693E-05	8.79972E-05	0	1	1	0	31280	11364	19916	0	0	0	157
21-27105583-G-C	6.37959E-05	0.000175469	0	2	2	0	31350	11398	19952	0	0	0	479
21-27105585-A-C	3.18837E-05	8.77501E-05	0	1	1	0	31364	11396	19968	0	0	0	233
21-27105586-A-C	3.18776E-05	0	5.00751E-05	1	0	1	31370	11400	19970	0	0	0	34
21-27105607-G-A	9.56755E-05	0.000263296	0	3	3	0	31356	11394	19962	0	0	0	181
21-27105613-G-T	3.18959E-05	0	5.00902E-05	1	0	1	31352	11388	19964	0	0	0	247
21-27105622-C-T	6.37999E-05	0.000175593	0	2	2	0	31348	11390	19958	0	0	0	176
21-27105636-C-T	0.000319163	0.000879353	0	10	10	0	31332	11372	19960	0	0	0	52
21-27105667-G-A	0.000511247	0.001320655	5.01555E-05	16	15	1	31296	11358	19938	0	0	0	375
21-27105669-T-C	3.19509E-05	0	5.01505E-05	1	0	1	31298	11358	19940	0	0	0	401
21-27105670-CT-C	3.18939E-05	8.77963E-05	0	1	1	0	31354	11390	19964	0	0	0	44
21-27105674-A-T	0.000414964	0.00114336	0	13	13	0	31328	11370	19958	0	0	0	103
21-27105675-C-A	3.18959E-05	0	5.00701E-05	1	0	1	31352	11380	19972	0	0	0	281
21-27105702-G-A	6.37714E-05	0.000175593	0	2	2	0	31362	11390	19972	0	0	0	321
21-27105714-A-C	3.20513E-05	0	5.02614E-05	1	0	1	31200	11304	19896	0	0	0	441
21-27105721-G-T	3.19918E-05	0	5.01655E-05	1	0	1	31258	11324	19934	0	0	0	159
21-27105725-C-T	9.56816E-05	0.00026362	0	3	3	0	31354	11380	19974	0	0	0	201
21-27105759-AC-A	9.56755E-05	0.000263204	0	3	3	0	31356	11398	19958	0	0	0	19
21-27105760-C-G	3.18959E-05	0	5.01102E-05	1	0	1	31352	11396	19956	0	0	0	478
21-27105787-G-C	3.18817E-05	0	5.00801E-05	1	0	1	31366	11398	19968	0	0	0	199
21-27105811-C-T	3.19203E-05	8.77809E-05	0	1	1	0	31328	11392	19936	0	0	0	403
21-27105815-G-C	0.0053341	0.011957095	0.001555132	167	136	31	31308	11374	19934	0	0	0	388
21-27105822-A-G	3.19163E-05	8.78426E-05	0	1	1	0	31332	11384	19948	0	0	0	12
21-27105824-C-G	3.19795E-05	0	5.02412E-05	1	0	1	31270	11366	19904	0	0	0	343
21-27105825-G-A	3.20143E-05	0	5.02917E-05	1	0	1	31236	11352	19884	0	0	0	79
21-27105848-T-G	3.19122E-05	8.78889E-05	0	1	1	0	31336	11378	19958	0	0	0	16
21-27105851-C-G	3.1902E-05	8.7858E-05	0	1	1	0	31346	11382	19964	0	0	0	482
21-27105863-A-AC	3.18776E-05	0	5.00551E-05	1	0	1	31370	11392	19978	0	0	0	370
21-27105864-C-T	3.19366E-05	8.79507E-05	0	1	1	0	31312	11370	19942	0	0	0	469
21-27105866-C-A	3.19264E-05	0	5.01253E-05	1	0	1	31322	11372	19950	0	0	0	498
21-27105871-A-C	3.18918E-05	8.79507E-05	0	1	1	0	31356	11370	19986	0	0	0	307
21-27105875-C-T	3.19305E-05	0	5.00701E-05	1	0	1	31318	11346	19972	0	0	0	335
21-27105886-C-T	0.002704269	0.007506702	0	84	84	0	31062	11190	19872	0	0	0	399
21-27105888-T-C	0.000193999	0.000540151	0	6	6	0	30928	11108	19820	0	0	0	456
21-27105889-A-C	9.63948E-05	0	0.000150135	3	0	3	31122	11140	19982	0	0	0	58
21-27105889-A-T	3.21316E-05	0	5.0045E-05	1	0	1	31122	11140	19982	0	0	0	387
21-27105894-C-CA	0.000265735	0.000669985	0	7	7	0	26342	10448	15894	0	0	0	215
21-27105894-C-CAA	0.051438767	0.126722818	0.001950422	1355	1324	31	26342	10448	15894	106	106	0	89
21-27105894-CA-C	7.59244E-05	0.000191424	0	2	2	0	26342	10448	15894	0	0	0	489
21-27105894-CAAA-C	0.000835168	0.000574273	0.001006669	22	6	16	26342	10448	15894	0	0	0	122
21-27105907-T-A	9.57304E-05	0.000263759	0	3	3	0	31338	11374	19964	0	0	0	135
21-27105908-G-T	9.58038E-05	0	0.000150225	3	0	3	31314	11344	19970	0	0	0	174
21-27105967-T-C	3.18593E-05	8.76885E-05	0	1	1	0	31388	11404	19984	0	0	0	229
21-27105978-G-T	9.56572E-05	0.000175377	5.01052E-05	3	2	1	31362	11404	19958	0	0	0	109
21-27105991-C-T	3.18552E-05	8.76424E-05	0	1	1	0	31392	11410	19982	0	0	0	265
21-27106021-A-G	3.18512E-05	0	5.003E-05	1	0	1	31396	11408	19988	0	0	0	128
21-27106046-C-T	3.18573E-05	0	5.002E-05	1	0	1	31390	11398	19992	0	0	0	171
21-27106049-T-C	6.36862E-05	0.000175285	0	2	2	0	31404	11410	19994	0	0	0	284
21-27106053-C-T	3.18451E-05	0	5.001E-05	1	0	1	31402	11406	19996	0	0	0	233
21-27106056-A-G	0.000127397	0	0.00020004	4	0	4	31398	11402	19996	0	0	0	471
21-27106063-TAA-T	9.55779E-05	8.77501E-05	0.00010004	3	1	2	31388	11396	19992	0	0	0	219
21-27106078-C-T	3.18512E-05	0	5.002E-05	1	0	1	31396	11404	19992	0	0	0	163
21-27106083-T-C	3.1839E-05	0	5.0005E-05	1	0	1	31408	11410	19998	0	0	0	231
21-27106087-C-T	3.18471E-05	0	5.0015E-05	1	0	1	31400	11406	19994	0	0	0	398
21-27106099-C-T	3.18431E-05	0	5.0015E-05	1	0	1	31404	11410	19994	0	0	0	452
21-27106113-G-A	6.37146E-05	0.000175285	0	2	2	0	31390	11410	19980	0	0	0	304
21-27106132-T-A	0.288243174	0.484973638	0.176146605	9037	5519	3518	31352	11380	19972	1731	1421	310	344
21-27106141-A-G	0.00012738	0	0.00020006	4	0	4	31402	11408	19994	0	0	0	239
21-27106146-CTCTAAG-C	3.18451E-05	8.76424E-05	0	1	1	0	31402	11410	19992	0	0	0	31
21-27106151-A-T	3.18431E-05	0	5.001E-05	1	0	1	31404	11408	19996	0	0	0	238
21-27106158-C-G	0.001273804	0.00324277	0.00015006	40	37	3	31402	11410	19992	0	0	0	333
21-27106185-A-G	3.18552E-05	8.77347E-05	0	1	1	0	31392	11398	19994	0	0	0	330
21-27106188-G-A	9.55718E-05	0.0001755	5.0015E-05	3	2	1	31390	11396	19994	0	0	0	24
21-27106189-G-T	3.18593E-05	0	5.0005E-05	1	0	1	31388	11390	19998	0	0	0	435
21-27106199-C-T	0.000191058	0.000175346	0.00020002	6	2	4	31404	11406	19998	0	0	0	456
21-27106208-T-C	0.00022293	0.000175316	0.0002501	7	2	5	31400	11408	19992	0	0	0	396
21-27106217-T-C	3.18471E-05	0	5.001E-05	1	0	1	31400	11404	19996	0	0	0	174
21-27106241-C-T	0.00025481	0.000701508	0	8	8	0	31396	11404	19992	0	0	0	315
21-27106265-T-C	3.18451E-05	0	5.002E-05	1	0	1	31402	11410	19992	0	0	0	281
21-27106295-GCATTCAA-G	6.36983E-05	0.000175377	0	2	2	0	31398	11404	19994	0	0	0	497
21-27106305-G-A	9.55353E-05	0.000262835	0	3	3	0	31402	11414	19988	0	0	0	230
21-27106320-A-G	3.18431E-05	8.76424E-05	0	1	1	0	31404	11410	19994	0	0	0	45
21-27106326-C-T	0.002738854	0.001139551	0.003651461	86	13	73	31400	11408	19992	0	0	0	199
21-27106329-A-G	3.1837E-05	8.76117E-05	0	1	1	0	31410	11414	19996	0	0	0	375
21-27106362-A-T	3.1835E-05	0	0.00005	1	0	1	31412	11412	20000	0	0	0	214
21-27106390-T-G	3.18492E-05	8.76732E-05	0	1	1	0	31398	11406	19992	0	0	0	3
21-27106391-C-A	3.18451E-05	8.76424E-05	0	1	1	0	31402	11410	19992	0	0	0	418
21-27106394-T-C	3.1841E-05	8.76424E-05	0	1	1	0	31406	11410	19996	0	0	0	168
21-27106412-A-T	0.001022168	0.002372583	0.000250928	32	27	5	31306	11380	19926	0	0	0	48
21-27106415-A-T	3.18817E-05	0	5.00701E-05	1	0	1	31366	11394	19972	0	0	0	83
21-27106433-A-T	0.030973169	0.084196664	0.00065026	972	959	13	31382	11390	19992	43	43	0	11
21-27106443-A-T	3.18451E-05	0	5.002E-05	1	0	1	31402	11410	19992	0	0	0	176
21-27106449-T-C	0.000191083	0.000262973	0.00015006	6	3	3	31400	11408	19992	0	0	0	464
21-27106452-T-A	3.18431E-05	0	5.001E-05	1	0	1	31404	11408	19996	0	0	0	344
21-27106454-A-G	6.36902E-05	0	0.00010003	2	0	2	31402	11408	19994	0	0	0	467
21-27106482-TGAC-T	0.001497006	0.000175346	0.002251126	47	2	45	31396	11406	19990	0	0	0	39
21-27106496-T-C	0.000414171	0.001140151	0	13	13	0	31388	11402	19986	0	0	0	400
21-27106508-AT-A	3.18654E-05	8.76732E-05	0	1	1	0	31382	11406	19976	0	0	0	299
21-27106516-C-T	0.007235752	0.019483939	0.000250275	227	222	5	31372	11394	19978	3	3	0	465
21-27106536-G-C	3.18837E-05	0	5.00551E-05	1	0	1	31364	11386	19978	0	0	0	152
21-27106550-G-A	0.0001914	0.000175778	0.0002003	6	2	4	31348	11378	19970	0	0	0	155
21-27106553-A-G	0.011267156	0.030876144	0.00010019	353	351	2	31330	11368	19962	9	9	0	432
21-27106559-G-C	0.000127616	0.000351494	0	4	4	0	31344	11380	19964	0	0	0	109
21-27106564-G-A	0.00015951	0.000351556	5.00801E-05	5	4	1	31346	11378	19968	0	0	0	160
21-27106571-G-GT	0.004145937	0	0.006511069	130	0	130	31356	11390	19966	1	0	1	408
21-27106583-T-C	3.19244E-05	0	5.01203E-05	1	0	1	31324	11372	19952	0	0	0	386
21-27106587-C-G	3.18979E-05	0	5.00701E-05	1	0	1	31350	11378	19972	0	0	0	230
21-27106590-A-G	3.1902E-05	8.79198E-05	0	1	1	0	31346	11374	19972	0	0	0	496
21-27106609-G-A	3.18898E-05	8.79198E-05	0	1	1	0	31358	11374	19984	0	0	0	347
21-27106615-G-C	3.18898E-05	8.79044E-05	0	1	1	0	31358	11376	19982	0	0	0	268
21-27106628-T-A	0.000159266	0	0.0002501	5	0	5	31394	11402	19992	0	0	0	377
21-27106637-G-A	3.18878E-05	0	5.00551E-05	1	0	1	31360	11382	19978	0	0	0	459
21-27106640-T-C	3.18674E-05	8.77347E-05	0	1	1	0	31380	11398	19982	0	0	0	258
21-27106644-C-A	3.18796E-05	0	5.00601E-05	1	0	1	31368	11392	19976	0	0	0	41
21-27106656-A-G	0.088820827	0.088168073	0.089192708	2784	1003	1781	31344	11376	19968	161	92	69	388
21-27106685-T-G	0.000318552	0.000877039	0	10	10	0	31392	11402	19990	0	0	0	151
21-27106708-G-A	3.18512E-05	8.76424E-05	0	1	1	0	31396	11410	19986	0	0	0	469
21-27106709-C-T	0.000222958	0.000175316	0.00025015	7	2	5	31396	11408	19988	0	0	0	478
21-27106718-G-A	3.18471E-05	0	5.003E-05	1	0	1	31400	11412	19988	0	0	0	429
21-27106722-T-C	3.18552E-05	0	5.0045E-05	1	0	1	31392	11410	19982	0	0	0	92
21-27106732-G-A	3.18634E-05	8.77039E-05	0	1	1	0	31384	11402	19982	0	0	0	459
21-27106738-A-T	3.18532E-05	8.76578E-05	0	1	1	0	31394	11408	19986	0	0	0	416
21-27106742-G-A	3.18593E-05	0	5.0035E-05	1	0	1	31388	11402	19986	0	0	0	70
21-27106744-G-C	3.18674E-05	8.77039E-05	0	1	1	0	31380	11402	19978	0	0	0	463
21-27106758-A-G	3.18532E-05	0	5.0035E-05	1	0	1	31394	11408	19986	0	0	0	59
21-27106759-T-G	0.031074707	0.084445225	0.00065052	975	962	13	31376	11392	19984	44	44	0	418
21-27106770-A-AT	0.000191241	0.000438827	5.00501E-05	6	5	1	31374	11394	19980	0	0	0	455
21-27106797-CT-C	6.37064E-05	0	0.00010007	2	0	2	31394	11408	19986	0	0	0	114
21-27106799-G-A	0.000478042	0.001139951	0.00010013	15	13	2	31378	11404	19974	0	0	0	103
21-27106804-A-G	9.56145E-05	0	0.000150255	3	0	3	31376	11410	19966	0	0	0	305
21-27106807-AGCC-A	6.37471E-05	0.000175408	0	2	2	0	31374	11402	19972	0	0	0	147
21-27106815-C-T	3.18735E-05	0	5.00701E-05	1	0	1	31374	11402	19972	0	0	0	390
21-27106826-G-A	0.136076152	0.098857645	0.157332129	4260	1125	3135	31306	11380	19926	343	69	274	6
21-27106830-G-A	3.18837E-05	8.77193E-05	0	1	1	0	31364	11400	19964	0	0	0	151
21-27106844-T-C	3.18898E-05	0	5.00952E-05	1	0	1	31358	11396	19962	0	0	0	391
21-27106865-C-T	3.18796E-05	0	5.00801E-05	1	0	1	31368	11400	19968	0	0	0	102
21-27106884-C-T	3.18878E-05	8.77655E-05	0	1	1	0	31360	11394	19966	0	0	0	432
21-27106909-C-A	0.000159581	0.000175685	0.000150391	5	2	3	31332	11384	19948	0	0	0	294
21-27106915-C-T	3.19326E-05	0	5.01454E-05	1	0	1	31316	11374	19942	0	0	0	395
21-27106918-C-A	3.19244E-05	0	5.01555E-05	1	0	1	31324	11386	19938	0	0	0	221
21-27106931-G-A	3.19795E-05	8.80127E-05	0	1	1	0	31270	11362	19908	0	0	0	252
21-27106960-T-C	3.19652E-05	8.79972E-05	0	1	1	0	31284	11364	19920	0	0	0	117
21-27106961-C-T	3.19101E-05	8.77963E-05	0	1	1	0	31338	11390	19948	0	0	0	365
21-27106962-G-A	3.19448E-05	8.79198E-05	0	1	1	0	31304	11374	19930	0	0	0	410
21-27106995-G-C	3.18796E-05	8.77193E-05	0	1	1	0	31368	11400	19968	0	0	0	202
21-27107009-A-C	3.18979E-05	0	5.00902E-05	1	0	1	31350	11386	19964	0	0	0	247
21-27107022-C-T	3.18654E-05	0	5.0045E-05	1	0	1	31382	11400	19982	0	0	0	39
21-27107026-G-A	3.18715E-05	8.77501E-05	0	1	1	0	31376	11396	19980	0	0	0	349
21-27107027-G-C	0.031014918	0.084269663	0.000650651	973	960	13	31372	11392	19980	43	43	0	488
21-27107034-C-T	0.008695929	0.002454848	0.012257354	273	28	245	31394	11406	19988	5	1	4	128
21-27107058-G-A	3.18532E-05	8.76732E-05	0	1	1	0	31394	11406	19988	0	0	0	241
21-27107059-C-T	3.18512E-05	0	5.0025E-05	1	0	1	31396	11406	19990	0	0	0	456
21-27107071-C-A	6.37105E-05	0	0.00010006	2	0	2	31392	11404	19988	0	0	0	405
21-27107131-A-T	3.18654E-05	8.77655E-05	0	1	1	0	31382	11394	19988	0	0	0	198
21-27107149-T-C	3.18613E-05	8.76885E-05	0	1	1	0	31386	11404	19982	0	0	0	366
21-27107151-C-T	3.18552E-05	8.76732E-05	0	1	1	0	31392	11406	19986	0	0	0	482
21-27107152-C-A	0.000318552	0.000876732	0	10	10	0	31392	11406	19986	0	0	0	25
21-27107179-G-A	3.18756E-05	0	5.00751E-05	1	0	1	31372	11402	19970	0	0	0	213
21-27107182-C-G	3.18512E-05	8.76271E-05	0	1	1	0	31396	11412	19984	0	0	0	280
21-27107183-T-G	3.18512E-05	8.76271E-05	0	1	1	0	31396	11412	19984	0	0	0	143
21-27107189-A-C	9.56511E-05	0.00026325	0	3	3	0	31364	11396	19968	0	0	0	343
21-27107193-T-TCCG	0.002262443	0.000262973	0.003404426	71	3	68	31382	11408	19974	0	0	0	185
21-27107198-C-CGCCACCACCTCCGCT	6.36983E-05	0	0.00010007	2	0	2	31398	11412	19986	0	0	0	364
21-27107202-A-G	0.011604923	0.031578947	0.000200341	364	360	4	31366	11400	19966	7	7	0	141
21-27107211-G-A	3.18776E-05	0	5.01002E-05	1	0	1	31370	11410	19960	0	0	0	273
21-27107224-C-T	3.18471E-05	0	5.0025E-05	1	0	1	31400	11410	19990	0	0	0	126
21-27107231-T-C	9.56511E-05	8.77193E-05	0.00010018	3	1	2	31364	11400	19964	0	0	0	358
21-27107241-C-A	3.18532E-05	8.76271E-05	0	1	1	0	31394	11412	19982	0	0	0	298
21-27107243-C-T	0.000127413	0.000350508	0	4	4	0	31394	11412	19982	0	0	0	108
21-27107251-C-G	0.011564192	0.030592567	0.000700631	363	349	14	31390	11408	19982	7	7	0	447
21-27107251-C-T	3.18573E-05	0	5.0045E-05	1	0	1	31390	11408	19982	0	0	0	81
21-27107256-T-C	6.37633E-05	0.0001755	0	2	2	0	31366	11396	19970	0	0	0	170
21-27107269-T-C	3.18593E-05	0	5.00551E-05	1	0	1	31388	11410	19978	0	0	0	57
21-27107282-C-G	3.18715E-05	8.76885E-05	0	1	1	0	31376	11404	19972	0	0	0	365
21-27107288-G-A	3.18573E-05	0	5.0045E-05	1	0	1	31390	11408	19982	0	0	0	347
21-27107288-G-T	3.18573E-05	0	5.0045E-05	1	0	1	31390	11408	19982	0	0	0	314
21-27107290-C-T	3.18654E-05	8.77039E-05	0	1	1	0	31382	11402	19980	0	0	0	300
21-27107291-G-A	3.18613E-05	8.76732E-05	0	1	1	0	31386	11406	19980	0	0	0	80
21-27107291-GA-G	3.18613E-05	0	5.00501E-05	1	0	1	31386	11406	19980	0	0	0	52
21-27107292-A-G	3.18715E-05	0	5.00701E-05	1	0	1	31376	11404	19972	0	0	0	448
21-27107296-T-C	3.18735E-05	8.76885E-05	0	1	1	0	31374	11404	19970	0	0	0	351
21-27107297-C-T	3.18492E-05	0	5.0035E-05	1	0	1	31398	11412	19986	0	0	0	65
21-27107301-G-A	3.18593E-05	0	5.00501E-05	1	0	1	31388	11408	19980	0	0	0	463
21-27107306-G-A	3.18492E-05	0	5.003E-05	1	0	1	31398	11410	19988	0	0	0	286
21-27107310-G-C	3.18492E-05	8.76271E-05	0	1	1	0	31398	11412	19986	0	0	0	326
21-27107326-C-T	6.37024E-05	0.000175254	0	2	2	0	31396	11412	19984	0	0	0	251
21-27107337-C-G	6.37389E-05	0.000175316	0	2	2	0	31378	11408	19970	0	0	0	32
21-27107357-G-A	6.37146E-05	0.000175346	0	2	2	0	31390	11406	19984	0	0	0	244
21-27107359-C-A	3.18552E-05	8.76732E-05	0	1	1	0	31392	11406	19986	0	0	0	313
21-27107359-C-T	0.000350408	0.000876732	5.0035E-05	11	10	1	31392	11406	19986	0	0	0	480
21-27107360-A-C	0.000478011	0.001227855	5.00551E-05	15	14	1	31380	11402	19978	0	0	0	365
21-27107376-T-C	3.18674E-05	0	5.00551E-05	1	0	1	31380	11402	19978	0	0	0	111
21-27107389-C-T	6.36983E-05	0.000175408	0	2	2	0	31398	11402	19996	0	0	0	48
21-27107405-C-G	3.18532E-05	0	5.002E-05	1	0	1	31394	11402	19992	0	0	0	1
21-27107405-C-T	3.18532E-05	0	5.002E-05	1	0	1	31394	11402	19992	0	0	0	81
21-27107416-C-T	3.18573E-05	8.77347E-05	0	1	1	0	31390	11398	19992	0	0	0	363
21-27107446-C-G	0.000159195	0.000175254	0.00015003	5	2	3	31408	11412	19996	0	0	0	189
21-27107446-C-T	3.1839E-05	0	5.001E-05	1	0	1	31408	11412	19996	0	0	0	105
21-27107448-T-G	3.18552E-05	8.76424E-05	0	1	1	0	31392	11410	19982	0	0	0	185
21-27107451-T-TC	3.18451E-05	8.76424E-05	0	1	1	0	31402	11410	19992	0	0	0	484
21-27107456-T-C	3.18634E-05	0	5.00501E-05	1	0	1	31384	11404	19980	0	0	0	37
21-27107461-G-T	6.37146E-05	0.000175377	0	2	2	0	31390	11404	19986	0	0	0	142
21-27107470-C-T	0.000127356	8.75964E-05	0.00015006	4	1	3	31408	11416	19992	0	0	0	400
21-27107472-C-T	3.1837E-05	0	5.001E-05	1	0	1	31410	11414	19996	0	0	0	433
21-27107497-C-T	3.1837E-05	0	5.0015E-05	1	0	1	31410	11416	19994	0	0	0	290
21-27107509-T-C	3.18471E-05	8.76424E-05	0	1	1	0	31400	11410	19990	0	0	0	265
21-27107511-C-G	0.009015036	0.02472383	5.0035E-05	283	282	1	31392	11406	19986	2	2	0	45
21-27107513-A-G	0.003026249	0.008324571	0	95	95	0	31392	11412	19980	2	2	0	399
21-27107517-C-G	0.001273561	0.003504468	0	40	40	0	31408	11414	19994	1	1	0	234
21-27107520-C-T	3.18451E-05	8.76271E-05	0	1	1	0	31402	11412	19990	0	0	0	379
21-27107528-C-T	3.18451E-05	8.76424E-05	0	1	1	0	31402	11410	19992	0	0	0	287
21-27107542-T-G	3.18552E-05	0	5.00501E-05	1	0	1	31392	11412	19980	0	0	0	356
21-27107549-T-A	0.00943276	0.025793999	0.00010009	296	294	2	31380	11398	19982	5	5	0	27
21-27107558-G-GTA	6.36902E-05	0	0.00010004	2	0	2	31402	11410	19992	0	0	0	116
21-27107569-C-A	3.18492E-05	8.76424E-05	0	1	1	0	31398	11410	19988	0	0	0	160
21-27107569-C-T	9.55475E-05	0.000262927	0	3	3	0	31398	11410	19988	0	0	0	262
21-27107571-G-A	3.1839E-05	0	5.001E-05	1	0	1	31408	11412	19996	0	0	0	139
21-27107573-G-A	3.18431E-05	8.76578E-05	0	1	1	0	31404	11408	19996	0	0	0	387
21-27107583-CTG-C	9.55475E-05	0	0.00015009	3	0	3	31398	11410	19988	0	0	0	341
21-27107590-A-G	0.003025285	0.008324571	0	95	95	0	31402	11412	19990	0	0	0	318
21-27107620-T-G	6.36943E-05	0	0.00010004	2	0	2	31400	11408	19992	0	0	0	435
21-27107622-G-A	6.36902E-05	8.76578E-05	5.0015E-05	2	1	1	31402	11408	19994	0	0	0	391
21-27107622-G-T	0.000159226	0	0.000250075	5	0	5	31402	11408	19994	0	0	0	176
21-27107623-T-C	0.011817545	0.032159131	0.00020018	371	367	4	31394	11412	19982	8	8	0	102
21-27107632-A-C	3.18532E-05	8.76578E-05	0	1	1	0	31394	11408	19986	0	0	0	20
21-27107637-C-T	3.1841E-05	0	5.0025E-05	1	0	1	31406	11416	19990	0	0	0	127
21-27107645-T-G	3.1839E-05	8.76117E-05	0	1	1	0	31408	11414	19994	0	0	0	88
21-27107651-G-T	3.18552E-05	8.77193E-05	0	1	1	0	31392	11400	19992	0	0	0	155
21-27107664-A-T	0.000255412	0	0.000401204	8	0	8	31322	11382	19940	0	0	0	369
21-27107680-T-G	0.000191229	0.000526501	0	6	6	0	31376	11396	19980	0	0	0	419
21-27107682-G-A	3.18654E-05	8.77501E-05	0	1	1	0	31382	11396	19986	0	0	0	292
21-27107693-G-A	9.56023E-05	0.00026325	0	3	3	0	31380	11396	19984	0	0	0	107
21-27107696-G-A	3.18512E-05	0	5.0015E-05	1	0	1	31396	11402	19994	0	0	0	133
21-27107711-G-C	0.000254907	8.77809E-05	0.00035014	8	1	7	31384	11392	19992	0	0	0	262
21-27107712-G-GA	0.000605134	0.001666374	0	19	19	0	31398	11402	19996	1	1	0	52
21-27107713-A-AG	3.19509E-05	0	5.01203E-05	1	0	1	31298	11346	19952	0	0	0	339
21-27107714-G-A	6.37227E-05	8.76885E-05	5.0045E-05	2	1	1	31386	11404	19982	0	0	0	194
21-27107719-G-C	6.37146E-05	8.76885E-05	5.0035E-05	2	1	1	31390	11404	19986	0	0	0	485
21-27107756-C-T	3.18674E-05	8.77193E-05	0	1	1	0	31380	11400	19980	0	0	0	34
21-27107758-G-C	6.37389E-05	0.000175439	0	2	2	0	31378	11400	19978	0	0	0	203
21-27107759-G-A	3.18634E-05	0	5.00551E-05	1	0	1	31384	11406	19978	0	0	0	228
21-27107763-C-G	6.37592E-05	0.000175439	0	2	2	0	31368	11400	19968	0	0	0	69
21-27107767-C-T	9.55962E-05	0.000263112	0	3	3	0	31382	11402	19980	0	0	0	101
21-27107768-A-C	0.023124522	0.063169917	0.000300451	725	719	6	31352	11382	19970	28	28	0	19
21-27107780-G-A	0.01590996	0.043363764	0.00025035	499	494	5	31364	11392	19972	12	12	0	332
21-27107796-A-C	0.000861299	0.002369668	0	27	27	0	31348	11394	19954	1	1	0	141
21-27107797-C-A	9.56267E-05	0.000263158	0	3	3	0	31372	11400	19972	0	0	0	103
21-27107801-G-A	3.18715E-05	0	5.00651E-05	1	0	1	31376	11402	19974	0	0	0	332
21-27107822-C-T	3.18857E-05	0	5.00701E-05	1	0	1	31362	11390	19972	0	0	0	283
21-27107828-C-G	0.000191363	0.000526963	0	6	6	0	31354	11386	19968	0	0	0	183
21-27107838-C-G	3.18796E-05	8.77501E-05	0	1	1	0	31368	11396	19972	0	0	0	401
21-27107843-C-T	3.18979E-05	0	5.01102E-05	1	0	1	31350	11394	19956	0	0	0	242
21-27107862-G-A	3.18878E-05	8.77347E-05	0	1	1	0	31360	11398	19962	0	0	0	160
21-27107884-G-A	3.18776E-05	8.77655E-05	0	1	1	0	31370	11394	19976	0	0	0	188
21-27107904-C-T	3.1904E-05	8.79353E-05	0	1	1	0	31344	11372	19972	0	0	0	151
21-27107905-G-A	3.1902E-05	8.78889E-05	0	1	1	0	31346	11378	19968	0	0	0	135
21-27107913-G-A	0.000191314	0.000527333	0	6	6	0	31362	11378	19984	0	0	0	159
21-27107924-G-A	3.19203E-05	8.80592E-05	0	1	1	0	31328	11356	19972	0	0	0	249
21-27107930-G-T	3.19183E-05	0	5.00851E-05	1	0	1	31330	11364	19966	0	0	0	107
21-27107931-C-G	3.19285E-05	8.80592E-05	0	1	1	0	31320	11356	19964	0	0	0	334
21-27107963-A-T	3.20082E-05	0	5.02361E-05	1	0	1	31242	11336	19906	0	0	0	463
21-27107964-C-G	0.000415256	0	0.000651368	13	0	13	31306	11348	19958	0	0	0	126
21-27107969-G-GC	9.61847E-05	0.000264971	0	3	3	0	31190	11322	19868	0	0	0	249
21-27107971-C-G	3.19468E-05	0	5.01253E-05	1	0	1	31302	11352	19950	0	0	0	341
21-27107976-C-G	6.39345E-05	8.81368E-05	5.01605E-05	2	1	1	31282	11346	19936	0	0	0	33
21-27107980-G-A	3.19816E-05	0	5.01706E-05	1	0	1	31268	11336	19932	0	0	0	162
21-27107985-C-T	3.19734E-05	8.81057E-05	0	1	1	0	31276	11350	19926	0	0	0	74
21-27107987-C-T	3.19857E-05	0	5.01958E-05	1	0	1	31264	11342	19922	0	0	0	340
21-27107989-G-C	3.19795E-05	8.81679E-05	0	1	1	0	31270	11342	19928	0	0	0	394
21-27108008-C-T	6.40615E-05	8.83392E-05	5.02513E-05	2	1	1	31220	11320	19900	0	0	0	56
21-27108010-C-T	0.005509642	0.01511669	5.02361E-05	172	171	1	31218	11312	19906	1	1	0	88
21-27108011-C-T	3.20842E-05	0	5.03423E-05	1	0	1	31168	11304	19864	0	0	0	143
21-27108015-G-T	0.001509119	0.004168145	0	47	47	0	31144	11276	19868	0	0	0	188
21-27108033-G-T	0.001765052	0	0.002764128	54	0	54	30594	11058	19536	0	0	0	200
21-27108064-A-C	0.012820513	0.041666667	0	1	1	0	78	24	54	0	0	0	313
21-27108075-A-AG	0.999965673	1	0.999946415	29131	10470	18661	29132	10470	18662	14565	5235	9330	110
21-27108081-G-A	3.27761E-05	9.0009E-05	0	1	1	0	30510	11110	19400	0	0	0	151
21-27108084-G-A	3.25669E-05	0	5.12715E-05	1	0	1	30706	11202	19504	0	0	0	17
21-27108090-G-C	3.444E-05	9.59877E-05	0	1	1	0	29036	10418	18618	0	0	0	146
21-27108104-G-T	0.0004901	0.000447227	0.000514774	15	5	10	30606	11180	19426	0	0	0	227
21-27108106-G-GGGCGAGC	9.7956E-05	0.000268192	0	3	3	0	30626	11186	19440	0	0	0	177
21-27108108-G-A	3.32182E-05	9.09422E-05	0	1	1	0	30104	10996	19108	0	0	0	466
21-27108122-G-A	3.30622E-05	0	5.20021E-05	1	0	1	30246	11016	19230	0	0	0	447
21-27108125-C-T	0.00501611	0.000796972	0.007467871	137	8	129	27312	10038	17274	0	0	0	168
21-27108128-G-T	0.00738948	0.019939469	0.000253088	229	224	5	30990	11234	19756	5	5	0	191
21-27108145-G-C	3.20862E-05	0	5.03525E-05	1	0	1	31166	11306	19860	0	0	0	193
21-27108166-G-GCCTGTCGCCGCTC	3.20082E-05	8.82924E-05	0	1	1	0	31242	11326	19916	0	0	0	441
21-27108176-G-A	3.19795E-05	0	5.01756E-05	1	0	1	31270	11340	19930	0	0	0	439
21-27108177-C-T	9.57916E-05	0.000263945	0	3	3	0	31318	11366	19952	0	0	0	259
21-27108181-C-G	3.19E-05	0	5.00751E-05	1	0	1	31348	11378	19970	0	0	0	270
21-27108188-C-G	0.000191461	0	0.000300541	6	0	6	31338	11374	19964	0	0	0	161
21-27108189-C-T	0.032450924	0.088333922	0.000701895	1015	1001	14	31278	11332	19946	53	53	0	283
21-27108192-G-A	0.000223799	0	0.00035137	7	0	7	31278	11356	19922	0	0	0	486
21-27108193-TC-T	0.001692426	0.00466057	0	53	53	0	31316	11372	19944	0	0	0	448
21-27108195-C-T	6.40533E-05	0	0.00010022	2	0	2	31224	11268	19956	0	0	0	204
21-27108197-C-T	3.1904E-05	0	5.00801E-05	1	0	1	31344	11376	19968	0	0	0	313
21-27108200-C-T	3.18898E-05	8.78272E-05	0	1	1	0	31358	11386	19972	0	0	0	342
21-27108212-C-T	0.000318878	8.7858E-05	0.000450496	10	1	9	31360	11382	19978	0	0	0	399
21-27108221-G-T	0.000127535	0	0.00020026	4	0	4	31364	11390	19974	0	0	0	409
21-27108240-C-T	3.18918E-05	8.78735E-05	0	1	1	0	31356	11380	19976	0	0	0	447
21-27108243-G-T	0.000159724	0.000440218	0	5	5	0	31304	11358	19946	0	0	0	345
21-27108264-G-A	0.009275196	0.025337542	0.00010016	291	289	2	31374	11406	19968	5	5	0	453
21-27108283-GCAGACC-G	3.18593E-05	0	5.00551E-05	1	0	1	31388	11410	19978	0	0	0	359
21-27108290-C-T	0.000509522	8.76271E-05	0.000750375	16	1	15	31402	11412	19990	0	0	0	330
21-27108293-T-C	3.18654E-05	8.77193E-05	0	1	1	0	31382	11400	19982	0	0	0	216
21-27108297-A-G	3.18573E-05	0	5.004E-05	1	0	1	31390	11406	19984	0	0	0	415
21-27108297-A-T	3.18573E-05	8.76732E-05	0	1	1	0	31390	11406	19984	0	0	0	304
21-27108309-A-T	0.000159357	0	0.0002503	5	0	5	31376	11400	19976	0	0	0	488
21-27108311-C-G	0.006724457	0.001842428	0.00950951	211	21	190	31378	11398	19980	1	0	1	214
21-27108324-T-G	3.18695E-05	0	5.00651E-05	1	0	1	31378	11404	19974	0	0	0	238
21-27108330-C-T	3.18715E-05	0	5.00651E-05	1	0	1	31376	11402	19974	0	0	0	198
21-27108336-T-C	3.18756E-05	8.77039E-05	0	1	1	0	31372	11402	19970	0	0	0	96
21-27108351-A-G	3.18918E-05	8.77039E-05	0	1	1	0	31356	11402	19954	0	0	0	7
21-27108353-A-G	0.001530319	0.004124978	5.00701E-05	48	47	1	31366	11394	19972	0	0	0	264
21-27108356-C-T	3.18674E-05	0	5.00551E-05	1	0	1	31380	11402	19978	0	0	0	303
21-27108378-A-G	0.00694356	0.002718344	0.009353741	218	31	187	31396	11404	19992	0	0	0	40
21-27108393-G-GT	0.026163161	0.005525346	0.037941736	821	63	758	31380	11402	19978	14	1	13	45
21-27108397-G-GT	0.006667943	0.018261633	5.01153E-05	209	208	1	31344	11390	19954	2	2	0	483
21-27108410-T-C	3.18512E-05	0	5.0035E-05	1	0	1	31396	11410	19986	0	0	0	168
21-27108416-AG-A	6.37024E-05	8.76732E-05	5.0025E-05	2	1	1	31396	11406	19990	0	0	0	29
21-27108429-A-G	3.1841E-05	0	5.0015E-05	1	0	1	31406	11412	19994	0	0	0	367
21-27108430-G-A	0.000159256	0.000175285	0.000150105	5	2	3	31396	11410	19986	0	0	0	266
21-27108468-T-C	3.18492E-05	8.76578E-05	0	1	1	0	31398	11408	19990	0	0	0	490
21-27108472-C-T	0.001818182	0.000263112	0.002707038	57	3	54	31350	11402	19948	0	0	0	227
21-27108474-A-G	9.55536E-05	0	0.00015009	3	0	3	31396	11408	19988	0	0	0	494
21-27108482-C-T	9.55414E-05	0.000262835	0	3	3	0	31400	11414	19986	0	0	0	167
21-27108512-C-A	6.37552E-05	0.000175562	0	2	2	0	31370	11392	19978	0	0	0	327
21-27108514-C-T	0.000127389	0	0.00020004	4	0	4	31400	11404	19996	0	0	0	483
21-27108520-G-A	3.18471E-05	8.76578E-05	0	1	1	0	31400	11408	19992	0	0	0	456
21-27108525-G-GA	6.3674E-05	0	0.0001	2	0	2	31410	11410	20000	0	0	0	280
21-27108536-C-A	3.18756E-05	0	5.00751E-05	1	0	1	31372	11402	19970	0	0	0	375
21-27108542-G-T	3.18471E-05	0	5.0025E-05	1	0	1	31400	11410	19990	0	0	0	1
21-27108556-T-C	3.18431E-05	8.76732E-05	0	1	1	0	31404	11406	19998	0	0	0	277
21-27108596-T-C	0.033445881	0.090877193	0.00070021	1050	1036	14	31394	11400	19994	56	56	0	459
21-27108612-C-T	9.55962E-05	0	0.00015009	3	0	3	31382	11394	19988	0	0	0	256
21-27108633-C-CT	3.18492E-05	0	5.002E-05	1	0	1	31398	11406	19992	0	0	0	471
21-27108675-A-G	3.18431E-05	8.76424E-05	0	1	1	0	31404	11410	19994	0	0	0	153
21-27108676-T-C	3.18451E-05	0	5.002E-05	1	0	1	31402	11410	19992	0	0	0	374
21-27108681-G-A	6.37024E-05	0.000175285	0	2	2	0	31396	11410	19986	0	0	0	293
21-27108683-A-C	0.000159195	0.000438135	0	5	5	0	31408	11412	19996	0	0	0	39
21-27108691-G-A	0.000191022	0.000525762	0	6	6	0	31410	11412	19998	0	0	0	258
21-27108705-C-T	0.000127389	0	0.0002001	4	0	4	31400	11410	19990	0	0	0	187
21-27108726-C-G	0.000127421	0	0.00020018	4	0	4	31392	11410	19982	0	0	0	241
21-27108744-T-C	0.022169841	0.007711181	0.030427385	696	88	608	31394	11412	19982	8	0	8	335
21-27108760-G-A	3.18532E-05	8.76732E-05	0	1	1	0	31394	11406	19988	0	0	0	120
21-27108764-G-A	3.18857E-05	8.77501E-05	0	1	1	0	31362	11396	19966	0	0	0	21
21-27108766-C-T	3.18512E-05	0	5.0025E-05	1	0	1	31396	11406	19990	0	0	0	161
21-27108767-T-G	3.18573E-05	0	5.0035E-05	1	0	1	31390	11404	19986	0	0	0	52
21-27108767-T-TA	0.000127429	0.000350754	0	4	4	0	31390	11404	19986	0	0	0	408
21-27108769-G-C	0.000223072	0.000526501	5.004E-05	7	6	1	31380	11396	19984	0	0	0	311
21-27108769-G-T	3.18674E-05	0	5.004E-05	1	0	1	31380	11396	19984	0	0	0	126
21-27108773-GTC-G	3.18613E-05	8.76424E-05	0	1	1	0	31386	11410	19976	0	0	0	423
21-27108800-CA-C	3.18634E-05	0	5.0045E-05	1	0	1	31384	11402	19982	0	0	0	209
21-27108803-G-T	3.18552E-05	0	5.0035E-05	1	0	1	31392	11406	19986	0	0	0	334
21-27108845-A-G	3.18471E-05	0	5.0025E-05	1	0	1	31400	11410	19990	0	0	0	262
21-27108851-A-G	0.001178119	0.003154021	5.002E-05	37	36	1	31406	11414	19992	0	0	0	311
21-27108892-C-T	3.18552E-05	0	5.002E-05	1	0	1	31392	11400	19992	0	0	0	215
21-27108905-GAAGT-G	0.002356388	0.006484402	0	74	74	0	31404	11412	19992	0	0	0	364
21-27108926-A-G	9.55171E-05	0.000262881	0	3	3	0	31408	11412	19996	0	0	0	448
21-27108934-G-A	3.18451E-05	0	5.001E-05	1	0	1	31402	11406	19996	0	0	0	88
21-27108942-C-T	6.3678E-05	0.000175254	0	2	2	0	31408	11412	19996	0	0	0	109
21-27108944-A-G	3.18451E-05	0	5.002E-05	1	0	1	31402	11410	19992	0	0	0	11
21-27108956-G-A	3.18573E-05	0	5.0035E-05	1	0	1	31390	11404	19986	0	0	0	225
21-27108957-A-C	3.18431E-05	0	5.0015E-05	1	0	1	31404	11410	19994	0	0	0	277
21-27108958-G-C	3.18471E-05	0	5.0015E-05	1	0	1	31400	11406	19994	0	0	0	49
21-27108960-A-G	0.003343523	0.009113214	5.002E-05	105	104	1	31404	11412	19992	0	0	0	272
21-27108982-T-A	3.18431E-05	8.76424E-05	0	1	1	0	31404	11410	19994	0	0	0	406
21-27108994-A-G	6.36862E-05	0.000175346	0	2	2	0	31404	11406	19998	0	0	0	169
21-27108998-CTT-C	3.18512E-05	8.76732E-05	0	1	1	0	31396	11406	19990	0	0	0	223
21-27109015-C-T	3.18512E-05	0	5.004E-05	1	0	1	31396	11412	19984	0	0	0	352
21-27109016-A-G	3.18309E-05	0	0.00005	1	0	1	31416	11416	20000	0	0	0	226
21-27109022-A-G	3.1839E-05	8.76271E-05	0	1	1	0	31408	11412	19996	0	0	0	315
21-27109073-C-T	0.000445718	0.001139152	5.0005E-05	14	13	1	31410	11412	19998	0	0	0	162
21-27109078-G-T	6.37511E-05	0	0.00010012	2	0	2	31372	11396	19976	0	0	0	123
21-27109083-C-T	3.18431E-05	0	5.001E-05	1	0	1	31404	11408	19996	0	0	0	77
21-27109097-T-C	3.1839E-05	0	5.0005E-05	1	0	1	31408	11410	19998	0	0	0	253
21-27109102-G-C	3.18492E-05	8.76578E-05	0	1	1	0	31398	11408	19990	0	0	0	177
21-27109106-G-T	6.37064E-05	0	0.00010007	2	0	2	31394	11408	19986	0	0	0	139
21-27109118-T-C	6.36821E-05	0.000175254	0	2	2	0	31406	11412	19994	0	0	0	318
21-27109141-C-A	0.017106269	0.004381353	0.024374374	537	50	487	31392	11412	19980	6	0	6	179
21-27109163-C-G	3.1839E-05	8.76271E-05	0	1	1	0	31408	11412	19996	0	0	0	331
21-27109207-C-G	3.18512E-05	8.76117E-05	0	1	1	0	31396	11414	19982	0	0	0	250
21-27109227-T-C	3.18431E-05	8.75964E-05	0	1	1	0	31404	11416	19988	0	0	0	235
21-27109237-T-C	3.1835E-05	0	5.001E-05	1	0	1	31412	11416	19996	0	0	0	259
21-27109250-G-T	3.18552E-05	8.76271E-05	0	1	1	0	31392	11412	19980	0	0	0	468
21-27109261-C-CA	3.18471E-05	8.75964E-05	0	1	1	0	31400	11416	19984	0	0	0	417
21-27109264-A-G	6.36983E-05	8.76578E-05	5.0025E-05	2	1	1	31398	11408	19990	0	0	0	483
21-27109298-T-C	9.55171E-05	0.000262835	0	3	3	0	31408	11414	19994	0	0	0	1
21-27109312-A-C	3.18329E-05	8.75964E-05	0	1	1	0	31414	11416	19998	0	0	0	150
21-27109322-A-G	3.1837E-05	8.76117E-05	0	1	1	0	31410	11414	19996	0	0	0	55
21-27109326-A-C	3.18431E-05	8.76424E-05	0	1	1	0	31404	11410	19994	0	0	0	101
21-27109346-C-T	3.18492E-05	0	5.003E-05	1	0	1	31398	11410	19988	0	0	0	397
21-27109366-G-A	3.18471E-05	8.76732E-05	0	1	1	0	31400	11406	19994	0	0	0	202
21-27109368-T-G	3.18492E-05	0	5.003E-05	1	0	1	31398	11410	19988	0	0	0	20
21-27109372-C-T	0.000127405	0.00035057	0	4	4	0	31396	11410	19986	0	0	0	468
21-27109392-C-A	3.18552E-05	8.76885E-05	0	1	1	0	31392	11404	19988	0	0	0	176
21-27109432-G-C	0.001274129	0.003506311	0	40	40	0	31394	11408	19986	1	1	0	291
21-27109472-G-T	0.000127356	0.000350385	0	4	4	0	31408	11416	19992	0	0	0	153
21-27109486-A-G	0.133380066	0.091817067	0.157135704	4186	1048	3138	31384	11414	19970	313	43	270	102
21-27109488-A-C	3.1835E-05	0	5.0005E-05	1	0	1	31412	11414	19998	0	0	0	48
21-27109493-G-A	3.1839E-05	0	5.0005E-05	1	0	1	31408	11410	19998	0	0	0	167
21-27109499-C-G	3.1837E-05	8.75964E-05	0	1	1	0	31410	11416	19994	0	0	0	169
21-27109499-C-T	3.1837E-05	8.75964E-05	0	1	1	0	31410	11416	19994	0	0	0	398
21-27109500-A-G	0.000127332	0	0.00020002	4	0	4	31414	11416	19998	0	0	0	151
21-27109515-G-A	3.18451E-05	0	5.001E-05	1	0	1	31402	11406	19996	0	0	0	112
21-27109515-G-T	0.033278135	0.090566369	0.00060012	1045	1033	12	31402	11406	19996	56	56	0	439
21-27109583-C-T	3.18573E-05	0	5.00551E-05	1	0	1	31390	11412	19978	0	0	0	218
21-27109593-A-G	3.1837E-05	0	5.0005E-05	1	0	1	31410	11412	19998	0	0	0	202
21-27109595-A-G	3.1837E-05	0	5.001E-05	1	0	1	31410	11414	19996	0	0	0	260
21-27109599-A-T	0.000668534	0.001839523	0	21	21	0	31412	11416	19996	0	0	0	214
21-27109614-G-C	9.57304E-05	0.000263389	0	3	3	0	31338	11390	19948	0	0	0	343
21-27109628-G-A	6.36943E-05	0	0.00010005	2	0	2	31400	11410	19990	0	0	0	123
21-27109630-T-G	0.000382239	0.000963898	5.0045E-05	12	11	1	31394	11412	19982	0	0	0	74
21-27109661-T-G	3.18431E-05	0	5.001E-05	1	0	1	31404	11408	19996	0	0	0	12
21-27109683-GT-G	3.18573E-05	0	5.00551E-05	1	0	1	31390	11412	19978	0	0	0	291
21-27109698-A-G	3.18471E-05	8.76271E-05	0	1	1	0	31400	11412	19988	0	0	0	139
21-27109699-C-CT	9.5584E-05	0.000262881	0	3	3	0	31386	11412	19974	0	0	0	122
21-27109701-A-G	3.18512E-05	8.76424E-05	0	1	1	0	31396	11410	19986	0	0	0	23
21-27109705-A-G	0.000732671	0.001577564	0.000250225	23	18	5	31392	11410	19982	0	0	0	17
21-27109706-T-C	3.18532E-05	8.76578E-05	0	1	1	0	31394	11408	19986	0	0	0	288
21-27109709-A-G	3.18532E-05	0	5.004E-05	1	0	1	31394	11410	19984	0	0	0	278
21-27109721-G-GAC	3.18715E-05	0	5.00701E-05	1	0	1	31376	11404	19972	0	0	0	25
21-27109734-A-C	0.000891833	0.002278304	0.00010008	28	26	2	31396	11412	19984	1	1	0	55
21-27109740-CTG-C	3.18715E-05	8.77039E-05	0	1	1	0	31376	11402	19974	0	0	0	341
21-27109749-A-G	3.18654E-05	0	5.00801E-05	1	0	1	31382	11414	19968	0	0	0	139
21-27109761-A-G	6.37024E-05	0.000175223	0	2	2	0	31396	11414	19982	0	0	0	291
21-27109763-C-T	3.18878E-05	8.76424E-05	0	1	1	0	31360	11410	19950	0	0	0	477
21-27109774-C-CCGAGTAA	3.18776E-05	0	5.00801E-05	1	0	1	31370	11402	19968	0	0	0	397
21-27109774-CTG-C	3.18776E-05	8.77039E-05	0	1	1	0	31370	11402	19968	0	0	0	319
21-27109774-CTGAG-C	0.000286898	0.000789335	0	9	9	0	31370	11402	19968	0	0	0	237
21-27109809-TTTTTG-T	0.008328015	0.0023705	0.011729323	261	27	234	31340	11390	19950	1	0	1	245
21-27109812-T-C	3.18796E-05	8.76271E-05	0	1	1	0	31368	11412	19956	0	0	0	415
21-27109824-G-GT	3.22622E-05	8.81213E-05	0	1	1	0	30996	11348	19648	0	0	0	154
21-27109830-T-C	0.000127559	8.76732E-05	0.000150361	4	1	3	31358	11406	19952	0	0	0	172
21-27109833-C-G	3.27033E-05	8.86839E-05	0	1	1	0	30578	11276	19302	0	0	0	2
21-27109833-C-T	0.000261626	0	0.000414465	8	0	8	30578	11276	19302	0	0	0	135
21-27109841-C-T	3.1953E-05	0	5.02513E-05	1	0	1	31296	11396	19900	0	0	0	167
21-27109879-C-G	3.1998E-05	0	5.03018E-05	1	0	1	31252	11372	19880	0	0	0	90
21-27109884-G-A	3.18959E-05	0	5.01253E-05	1	0	1	31352	11402	19950	0	0	0	190
21-27109889-AT-A	6.37633E-05	0.000175346	0	2	2	0	31366	11406	19960	0	0	0	75
21-27109902-A-G	3.18817E-05	0	5.01153E-05	1	0	1	31366	11412	19954	0	0	0	81
21-27109903-A-G	0.000159357	0.000438135	0	5	5	0	31376	11412	19964	0	0	0	392
21-27109921-T-TA	0.000191192	0.000525762	0	6	6	0	31382	11412	19970	0	0	0	172
21-27109945-C-G	3.18756E-05	8.76271E-05	0	1	1	0	31372	11412	19960	0	0	0	305
21-27109968-A-G	3.18634E-05	0	5.00551E-05	1	0	1	31384	11406	19978	0	0	0	171
21-27109978-C-T	9.56023E-05	0	0.000150195	3	0	3	31380	11406	19974	0	0	0	161
21-27109986-A-G	0.004620778	0.011222164	0.000851106	145	128	17	31380	11406	19974	0	0	0	75
21-27109991-A-C	3.18715E-05	8.77039E-05	0	1	1	0	31376	11402	19974	0	0	0	281
21-27109993-A-C	6.37552E-05	8.76732E-05	5.00902E-05	2	1	1	31370	11406	19964	0	0	0	410
21-27110005-T-TC	3.18898E-05	0	5.01303E-05	1	0	1	31358	11410	19948	0	0	0	147
21-27110008-A-G	3.20657E-05	0	5.04745E-05	1	0	1	31186	11374	19812	0	0	0	57
21-27110011-T-C	3.18918E-05	8.77347E-05	0	1	1	0	31356	11398	19958	0	0	0	294
21-27110027-A-G	3.18837E-05	0	5.01002E-05	1	0	1	31364	11404	19960	0	0	0	140
21-27110029-A-G	3.18695E-05	8.76271E-05	0	1	1	0	31378	11412	19966	0	0	0	177
21-27110030-AT-A	3.18695E-05	0	5.00851E-05	1	0	1	31378	11412	19966	0	0	0	477
21-27110048-T-A	0.000159571	0.000438443	0	5	5	0	31334	11404	19930	0	0	0	482
21-27110090-G-A	6.38081E-05	0	0.000100251	2	0	2	31344	11394	19950	0	0	0	127
21-27110106-AT-A	0.007209391	0.019402985	0.000250526	226	221	5	31348	11390	19958	3	3	0	152
21-27110114-T-A	0.009364847	0.024894811	0.00050035	294	284	10	31394	11408	19986	2	2	0	245
21-27110127-G-T	6.37755E-05	0.000175346	0	2	2	0	31360	11406	19954	0	0	0	61
21-27110143-T-C	9.55353E-05	0.000262927	0	3	3	0	31402	11410	19992	0	0	0	211
21-27110150-T-C	3.18492E-05	0	5.0025E-05	1	0	1	31398	11408	19990	0	0	0	334
21-27110162-A-G	3.18715E-05	8.77039E-05	0	1	1	0	31376	11402	19974	0	0	0	281
21-27110165-G-GT	6.37836E-05	8.77347E-05	5.01052E-05	2	1	1	31356	11398	19958	0	0	0	351
21-27110183-A-G	6.37511E-05	8.76732E-05	5.00851E-05	2	1	1	31372	11406	19966	0	0	0	449
21-27110188-G-A	3.18979E-05	8.77039E-05	0	1	1	0	31350	11402	19948	0	0	0	365
21-27110237-C-G	3.18492E-05	0	5.002E-05	1	0	1	31398	11406	19992	0	0	0	75
21-27110240-TC-T	3.18492E-05	8.76578E-05	0	1	1	0	31398	11408	19990	0	0	0	75
21-27110263-A-G	3.1839E-05	8.76271E-05	0	1	1	0	31408	11412	19996	0	0	0	205
21-27110264-C-T	3.18634E-05	0	5.00501E-05	1	0	1	31384	11404	19980	0	0	0	380
21-27110270-T-TA	9.55414E-05	0	0.000150075	3	0	3	31400	11410	19990	0	0	0	168
21-27110285-G-A	3.18512E-05	0	5.003E-05	1	0	1	31396	11408	19988	0	0	0	336
21-27110330-A-G	3.18634E-05	0	5.0035E-05	1	0	1	31384	11398	19986	0	0	0	276
21-27110331-T-C	3.18492E-05	8.76885E-05	0	1	1	0	31398	11404	19994	0	0	0	183
21-27110337-C-A	3.18512E-05	8.76578E-05	0	1	1	0	31396	11408	19988	0	0	0	271
21-27110337-C-T	3.18512E-05	0	5.003E-05	1	0	1	31396	11408	19988	0	0	0	67
21-27110369-CTTAG-C	0.000286752	8.77193E-05	0.00040028	9	1	8	31386	11400	19986	0	0	0	258
21-27110379-G-A	3.18634E-05	8.77039E-05	0	1	1	0	31384	11402	19982	0	0	0	428
21-27110419-A-G	0.00038219	0.001052262	0	12	12	0	31398	11404	19994	0	0	0	270
21-27110425-C-G	0.00213471	0.004913143	0.00055033	67	56	11	31386	11398	19988	1	1	0	207
21-27110445-T-C	6.36862E-05	0.000175346	0	2	2	0	31404	11406	19998	0	0	0	435
21-27110457-A-C	6.3674E-05	0.000175254	0	2	2	0	31410	11412	19998	0	0	0	252
21-27110468-T-C	3.1839E-05	8.76117E-05	0	1	1	0	31408	11414	19994	0	0	0	237
21-27110471-G-A	6.37024E-05	0.000175346	0	2	2	0	31396	11406	19990	0	0	0	275
21-27110475-AT-A	3.1839E-05	0	5.0015E-05	1	0	1	31408	11414	19994	0	0	0	94
21-27110479-T-C	9.55231E-05	0	0.00015003	3	0	3	31406	11410	19996	0	0	0	118
21-27110481-T-C	6.36821E-05	8.76424E-05	5.001E-05	2	1	1	31406	11410	19996	0	0	0	99
21-27110522-T-TGCC	0.000382239	0.00035057	0.00040032	12	4	8	31394	11410	19984	0	0	0	347
21-27110525-C-T	6.37389E-05	0.000175439	0	2	2	0	31378	11400	19978	0	0	0	124
21-27110531-C-T	3.18492E-05	0	5.001E-05	1	0	1	31398	11402	19996	0	0	0	287
21-27110532-G-GCCGCCC	3.18695E-05	8.76424E-05	0	1	1	0	31378	11410	19968	0	0	0	164
21-27110539-C-G	3.1839E-05	8.76271E-05	0	1	1	0	31408	11412	19996	0	0	0	373
21-27110539-C-T	6.3678E-05	0.000175254	0	2	2	0	31408	11412	19996	0	0	0	137
21-27110545-C-T	3.1837E-05	0	5.0005E-05	1	0	1	31410	11412	19998	0	0	0	148
21-27110556-CAT-C	0.000541229	0.001401787	5.001E-05	17	16	1	31410	11414	19996	0	0	0	339
21-27110593-C-T	0.117861017	0.203023378	0.069324785	3694	2310	1384	31342	11378	19964	325	281	44	428
21-27110611-T-G	0.017415945	0.004995618	0.02450245	547	57	490	31408	11410	19998	5	0	5	107
21-27110630-C-G	3.18613E-05	8.77347E-05	0	1	1	0	31386	11398	19988	0	0	0	451
21-27110630-CTGAGT-C	3.18613E-05	8.77347E-05	0	1	1	0	31386	11398	19988	0	0	0	280
21-27110650-G-T	0.1154018	0.196538394	0.069115878	3616	2237	1379	31334	11382	19952	288	246	42	328
21-27110653-A-G	9.55962E-05	0	0.000150195	3	0	3	31382	11408	19974	0	0	0	35
21-27110664-C-G	3.18471E-05	0	5.0025E-05	1	0	1	31400	11410	19990	0	0	0	381
21-27110672-A-G	3.18715E-05	8.76885E-05	0	1	1	0	31376	11404	19972	0	0	0	285
21-27110672-A-T	3.18715E-05	8.76885E-05	0	1	1	0	31376	11404	19972	0	0	0	361
21-27110675-C-T	3.18573E-05	0	5.0045E-05	1	0	1	31390	11408	19982	0	0	0	195
21-27110691-A-G	3.19E-05	0	5.01102E-05	1	0	1	31348	11392	19956	0	0	0	85
21-27110700-C-G	3.18939E-05	8.77655E-05	0	1	1	0	31354	11394	19960	0	0	0	22
21-27110720-C-G	3.18654E-05	8.76424E-05	0	1	1	0	31382	11410	19972	0	0	0	36
21-27110726-C-G	6.3743E-05	0	0.0001001	2	0	2	31376	11396	19980	0	0	0	180
21-27110766-C-T	3.18776E-05	0	5.00601E-05	1	0	1	31370	11394	19976	0	0	0	16
21-27110776-T-A	9.55353E-05	0.000262973	0	3	3	0	31402	11408	19994	0	0	0	495
21-27110801-C-T	3.18796E-05	8.76732E-05	0	1	1	0	31368	11406	19962	0	0	0	38
21-27110819-A-G	9.55718E-05	0.000175377	5.0035E-05	3	2	1	31390	11404	19986	0	0	0	221
21-27110822-T-C	3.18532E-05	0	5.003E-05	1	0	1	31394	11406	19988	0	0	0	344
21-27110832-T-C	0.00012738	0	0.00020004	4	0	4	31402	11406	19996	0	0	0	215
21-27110850-AT-A	3.18674E-05	0	5.00651E-05	1	0	1	31380	11406	19974	0	0	0	222
21-27110860-A-G	6.37024E-05	0.000175346	0	2	2	0	31396	11406	19990	0	0	0	88
21-27110876-C-T	3.19366E-05	8.77655E-05	0	1	1	0	31312	11394	19918	0	0	0	494
21-27110877-C-T	3.19305E-05	0	5.01756E-05	1	0	1	31318	11388	19930	0	0	0	39
21-27110881-G-T	3.19101E-05	0	5.01404E-05	1	0	1	31338	11394	19944	0	0	0	122
21-27110902-A-G	3.1957E-05	8.79198E-05	0	1	1	0	31292	11374	19918	0	0	0	60
21-27110910-C-A	3.18756E-05	8.77039E-05	0	1	1	0	31372	11402	19970	0	0	0	387
21-27110930-G-A	3.18817E-05	0	5.01153E-05	1	0	1	31366	11412	19954	0	0	0	391
21-27110938-A-T	3.18573E-05	8.76578E-05	0	1	1	0	31390	11408	19982	0	0	0	407
21-27110941-C-A	3.18552E-05	0	5.00551E-05	1	0	1	31392	11414	19978	0	0	0	96
21-27110985-C-T	3.18878E-05	8.76732E-05	0	1	1	0	31360	11406	19954	0	0	0	421
21-27110991-C-A	0.020057398	0.054435484	0.000400962	629	621	8	31360	11408	19952	20	20	0	191
21-27111004-CAT-C	0.000382555	0.001051893	0	12	12	0	31368	11408	19960	0	0	0	209
21-27111030-T-C	6.37471E-05	0	0.00010014	2	0	2	31374	11402	19972	0	0	0	27
21-27111042-G-C	0.00015952	8.77193E-05	0.000200562	5	1	4	31344	11400	19944	0	0	0	119
21-27111070-T-TA	3.18939E-05	0	5.01203E-05	1	0	1	31354	11402	19952	0	0	0	430
21-27111077-G-A	3.19203E-05	8.77963E-05	0	1	1	0	31328	11390	19938	0	0	0	232
21-27111118-C-T	0.000255249	0.000702247	0	8	8	0	31342	11392	19950	0	0	0	337
21-27111124-C-T	3.19061E-05	8.77501E-05	0	1	1	0	31342	11396	19946	0	0	0	217
21-27111127-C-T	0.000191351	0.000175439	0.000200441	6	2	4	31356	11400	19956	0	0	0	457
21-27111197-T-A	3.21295E-05	0	5.06175E-05	1	0	1	31124	11368	19756	0	0	0	180
21-27111212-G-C	3.22456E-05	8.83236E-05	0	1	1	0	31012	11322	19690	0	0	0	297
21-27111213-C-G	3.22622E-05	0	5.08388E-05	1	0	1	30996	11326	19670	0	0	0	371
21-27111213-CTTA-C	3.22622E-05	8.82924E-05	0	1	1	0	30996	11326	19670	0	0	0	241
21-27111218-T-C	0.000193449	0.00053041	0	6	6	0	31016	11312	19704	0	0	0	442
21-27111230-A-T	3.26115E-05	9.02527E-05	0	1	1	0	30664	11080	19584	0	0	0	331
21-27111234-A-G	6.5304E-05	0.000181521	0	2	2	0	30626	11018	19608	0	0	0	448
21-27111235-G-GA	0.000395789	0.000294406	0.000464314	10	3	7	25266	10190	15076	0	0	0	401
21-27111235-G-GAA	0.000831156	0.002060844	0	21	21	0	25266	10190	15076	0	0	0	232
21-27111235-GA-G	0.044961608	0.105691855	0.003913505	1136	1077	59	25266	10190	15076	59	59	0	69
21-27111235-GAAA-G	0.00071242	0.001766438	0	18	18	0	25266	10190	15076	0	0	0	196
21-27111245-A-C	3.22664E-05	0	5.08595E-05	1	0	1	30992	11330	19662	0	0	0	196
21-27111247-C-A	0.032845762	0.088656289	0.000771208	1006	991	15	30628	11178	19450	53	53	0	362
21-27111295-T-C	3.21854E-05	0	5.06842E-05	1	0	1	31070	11340	19730	0	0	0	161
21-27111305-G-T	3.20184E-05	8.78272E-05	0	1	1	0	31232	11386	19846	0	0	0	133
21-27111318-T-TA	3.19509E-05	0	5.02563E-05	1	0	1	31298	11400	19898	0	0	0	155
21-27111320-T-C	3.19244E-05	8.77193E-05	0	1	1	0	31324	11400	19924	0	0	0	321
21-27111325-G-A	3.19285E-05	0	5.01857E-05	1	0	1	31320	11394	19926	0	0	0	415
21-27111325-G-T	3.19285E-05	8.77655E-05	0	1	1	0	31320	11394	19926	0	0	0	316
21-27111352-A-C	3.18979E-05	8.77039E-05	0	1	1	0	31350	11402	19948	0	0	0	121
21-27111360-G-C	3.18715E-05	8.76732E-05	0	1	1	0	31376	11406	19970	0	0	0	151
21-27111365-C-G	3.18674E-05	0	5.00701E-05	1	0	1	31380	11408	19972	0	0	0	88
21-27111368-A-T	3.18776E-05	0	5.01002E-05	1	0	1	31370	11410	19960	0	0	0	495
21-27111374-C-G	3.18715E-05	8.76732E-05	0	1	1	0	31376	11406	19970	0	0	0	286
21-27111374-C-T	3.18715E-05	8.76732E-05	0	1	1	0	31376	11406	19970	0	0	0	398
21-27111386-C-T	3.18573E-05	0	5.00551E-05	1	0	1	31390	11412	19978	0	0	0	65
21-27111407-G-T	0.002740774	0.000438289	0.004056084	86	5	81	31378	11408	19970	0	0	0	348
21-27111443-G-T	6.37552E-05	0	0.00010017	2	0	2	31370	11404	19966	0	0	0	88
21-27111474-G-A	3.18756E-05	0	5.00751E-05	1	0	1	31372	11402	19970	0	0	0	104
21-27111498-A-C	3.18573E-05	0	5.0045E-05	1	0	1	31390	11408	19982	0	0	0	226
21-27111499-G-T	9.55779E-05	0.000263066	0	3	3	0	31388	11404	19984	0	0	0	350
21-27111507-A-G	6.37267E-05	0	0.00010009	2	0	2	31384	11402	19982	0	0	0	219
21-27111514-G-A	6.37227E-05	0.000175346	0	2	2	0	31386	11406	19980	0	0	0	188
21-27111524-A-G	0.007040459	0.019015072	0.00020022	221	217	4	31390	11412	19978	4	4	0	36
21-27111545-C-T	9.55597E-05	0.000262927	0	3	3	0	31394	11410	19984	0	0	0	195
21-27111561-T-C	3.1839E-05	0	5.0015E-05	1	0	1	31408	11414	19994	0	0	0	208
21-27111562-T-C	3.18451E-05	8.76271E-05	0	1	1	0	31402	11412	19990	0	0	0	180
21-27111574-A-G	3.1841E-05	8.76424E-05	0	1	1	0	31406	11410	19996	0	0	0	423
21-27111606-G-A	3.18471E-05	0	5.0015E-05	1	0	1	31400	11406	19994	0	0	0	42
21-27111628-G-T	0.000191022	0	0.00030006	6	0	6	31410	11414	19996	0	0	0	437
21-27111676-A-G	0.00012738	0	0.00020008	4	0	4	31402	11410	19992	0	0	0	322
21-27111709-G-C	3.18532E-05	0	5.003E-05	1	0	1	31394	11406	19988	0	0	0	456
21-27111734-GCCAGTGCTGTTTTT-G	9.55353E-05	0.000262881	0	3	3	0	31402	11412	19990	0	0	0	109
21-27111735-C-T	9.5584E-05	8.76732E-05	0.0001001	3	1	2	31386	11406	19980	0	0	0	275
21-27111737-A-G	3.18471E-05	0	5.002E-05	1	0	1	31400	11408	19992	0	0	0	111
21-27111743-G-A	3.18512E-05	8.76271E-05	0	1	1	0	31396	11412	19984	0	0	0	199
21-27111744-T-C	6.36902E-05	0	0.00010005	2	0	2	31402	11412	19990	0	0	0	138
21-27111769-T-G	0.000414171	0.001140151	0	13	13	0	31388	11402	19986	0	0	0	165
21-27111776-C-T	0.000541367	0.001490182	0	17	17	0	31402	11408	19994	0	0	0	48
21-27111785-C-T	3.1839E-05	0	5.0015E-05	1	0	1	31408	11414	19994	0	0	0	150
21-27111788-T-A	0.000222902	0	0.00035021	7	0	7	31404	11416	19988	0	0	0	440
21-27111808-T-C	0.000159226	0.000438135	0	5	5	0	31402	11412	19990	0	0	0	388
21-27111850-GC-G	3.18573E-05	0	5.004E-05	1	0	1	31390	11406	19984	0	0	0	421
21-27111860-A-G	3.18532E-05	8.77039E-05	0	1	1	0	31394	11402	19992	0	0	0	103
21-27111863-TC-T	3.18471E-05	8.76424E-05	0	1	1	0	31400	11410	19990	0	0	0	226
21-27111870-A-G	3.18674E-05	8.77039E-05	0	1	1	0	31380	11402	19978	0	0	0	464
21-27111873-G-T	6.3743E-05	0	0.0001001	2	0	2	31376	11396	19980	0	0	0	238
21-27111879-C-T	6.37146E-05	0.000175408	0	2	2	0	31390	11402	19988	0	0	0	256
21-27111884-GCT-G	6.37674E-05	8.77963E-05	5.00651E-05	2	1	1	31364	11390	19974	0	0	0	444
21-27111909-A-G	3.18837E-05	8.77809E-05	0	1	1	0	31364	11392	19972	0	0	0	91
21-27111913-T-C	0.102666326	0.096995256	0.105898258	3219	1104	2115	31354	11382	19972	191	94	97	407
21-27111957-C-A	0.000923332	8.76271E-05	0.00140028	29	1	28	31408	11412	19996	0	0	0	130
21-27111967-C-T	6.36943E-05	0.000175316	0	2	2	0	31400	11408	19992	0	0	0	27
21-27111998-T-C	9.55414E-05	8.76271E-05	0.00010006	3	1	2	31400	11412	19988	0	0	0	162
21-27112012-G-A	0.008984898	0.024552788	0.00010009	282	280	2	31386	11404	19982	5	5	0	140
21-27112028-C-G	3.18431E-05	8.76424E-05	0	1	1	0	31404	11410	19994	0	0	0	30
21-27112046-C-T	0.000159195	0.00035057	5.0005E-05	5	4	1	31408	11410	19998	0	0	0	458
21-27112118-A-C	9.55718E-05	0.000263158	0	3	3	0	31390	11400	19990	0	0	0	305
21-27112120-G-C	0.000286716	0	0.000450315	9	0	9	31390	11404	19986	0	0	0	146
21-27112155-A-C	3.18674E-05	8.76732E-05	0	1	1	0	31380	11406	19974	0	0	0	180
21-27112187-C-A	6.36902E-05	0.000175254	0	2	2	0	31402	11412	19990	0	0	0	21
21-27112195-T-A	6.36821E-05	0.000175254	0	2	2	0	31406	11412	19994	0	0	0	74
21-27112199-G-A	3.18512E-05	0	5.003E-05	1	0	1	31396	11408	19988	0	0	0	98
21-27112209-A-G	3.18512E-05	0	5.0025E-05	1	0	1	31396	11406	19990	0	0	0	172
21-27112218-C-T	6.36943E-05	0.000175285	0	2	2	0	31400	11410	19990	0	0	0	76
21-27112219-G-A	3.18492E-05	8.76424E-05	0	1	1	0	31398	11410	19988	0	0	0	216
21-27112222-T-C	3.18451E-05	8.76271E-05	0	1	1	0	31402	11412	19990	0	0	0	279
21-27112229-C-G	3.18532E-05	8.76424E-05	0	1	1	0	31394	11410	19984	0	0	0	337
21-27112229-C-T	3.18532E-05	0	5.004E-05	1	0	1	31394	11410	19984	0	0	0	138
21-27112267-T-C	0.001943046	0.005349	0	61	61	0	31394	11404	19990	1	1	0	332
21-27112273-C-A	6.37146E-05	0	0.00010006	2	0	2	31390	11402	19988	0	0	0	126
21-27112274-T-C	0.12116672	0.147647472	0.106066673	3801	1682	2119	31370	11392	19978	248	149	99	81
21-27112275-G-A	3.18532E-05	8.76885E-05	0	1	1	0	31394	11404	19990	0	0	0	36
21-27112279-A-C	3.18451E-05	0	5.001E-05	1	0	1	31402	11406	19996	0	0	0	475
21-27112295-C-G	3.18593E-05	0	5.0025E-05	1	0	1	31388	11398	19990	0	0	0	58
21-27112364-T-C	0.000700905	8.76885E-05	0.001050841	22	1	21	31388	11404	19984	0	0	0	274
21-27112372-A-T	3.18715E-05	8.77193E-05	0	1	1	0	31376	11400	19976	0	0	0	302
21-27112372-AT-A	0.000254972	0	0.000400481	8	0	8	31376	11400	19976	0	0	0	451
21-27112374-A-G	6.37714E-05	0.000175377	0	2	2	0	31362	11404	19958	0	0	0	131
21-27112375-T-C	3.18552E-05	0	5.003E-05	1	0	1	31392	11404	19988	0	0	0	278
21-27112377-C-T	3.18776E-05	8.77347E-05	0	1	1	0	31370	11398	19972	0	0	0	303
21-27112380-A-G	3.18613E-05	0	5.00501E-05	1	0	1	31386	11406	19980	0	0	0	299
21-27112389-C-T	0.000223029	0.000175439	0.000250175	7	2	5	31386	11400	19986	0	0	0	485
21-27112417-C-G	3.18573E-05	8.76885E-05	0	1	1	0	31390	11404	19986	0	0	0	10
21-27112425-A-C	3.18654E-05	0	5.004E-05	1	0	1	31382	11398	19984	0	0	0	365
21-27112430-T-TAC	0.000159215	0.000175285	0.000150045	5	2	3	31404	11410	19994	0	0	0	440
21-27112458-G-A	6.3674E-05	0	0.00010001	2	0	2	31410	11412	19998	0	0	0	407
21-27112471-A-G	3.1839E-05	0	5.0005E-05	1	0	1	31408	11410	19998	0	0	0	481
21-27112472-C-G	9.55171E-05	0	0.00015	3	0	3	31408	11408	20000	0	0	0	118
21-27112505-G-C	3.1839E-05	8.76271E-05	0	1	1	0	31408	11412	19996	0	0	0	71
21-27112537-A-G	6.36821E-05	0	0.00010001	2	0	2	31406	11408	19998	0	0	0	201
21-27112538-T-C	3.1837E-05	8.76271E-05	0	1	1	0	31410	11412	19998	0	0	0	60
21-27112544-G-A	6.3678E-05	0	0.0001	2	0	2	31408	11408	20000	0	0	0	399
21-27112549-T-C	3.18309E-05	0	0.00005	1	0	1	31416	11416	20000	0	0	0	97
21-27112572-C-T	3.18431E-05	0	5.0015E-05	1	0	1	31404	11410	19994	0	0	0	189
21-27112606-C-A	6.36821E-05	0.000175285	0	2	2	0	31406	11410	19996	0	0	0	496
21-27112610-A-G	0.000573102	0	0.00090018	18	0	18	31408	11412	19996	0	0	0	153
21-27112652-A-G	3.1837E-05	8.76117E-05	0	1	1	0	31410	11414	19996	0	0	0	441
21-27112653-T-C	0.000254728	0.000701016	0	8	8	0	31406	11412	19994	0	0	0	390
21-27112656-C-T	3.18431E-05	8.76271E-05	0	1	1	0	31404	11412	19992	0	0	0	234
21-27112679-G-A	3.18532E-05	8.77039E-05	0	1	1	0	31394	11402	19992	0	0	0	476
21-27112700-CT-C	3.18573E-05	0	5.0035E-05	1	0	1	31390	11404	19986	0	0	0	316
21-27112720-G-A	0.000127364	0.000262927	5.001E-05	4	3	1	31406	11410	19996	0	0	0	427
21-27112726-A-G	3.1839E-05	0	5.0015E-05	1	0	1	31408	11414	19994	0	0	0	245
21-27112727-A-ATAAC	3.1835E-05	0	5.001E-05	1	0	1	31412	11416	19996	0	0	0	243
21-27112728-TAACTAC-T	6.36902E-05	0	0.00010005	2	0	2	31402	11412	19990	0	0	0	467
21-27112746-T-C	0.00703732	0.019021739	0.00020004	221	217	4	31404	11408	19996	4	4	0	154
21-27112762-G-A	3.18471E-05	0	5.0025E-05	1	0	1	31400	11410	19990	0	0	0	368
21-27112764-A-G	3.1841E-05	0	5.0015E-05	1	0	1	31406	11412	19994	0	0	0	251
21-27112772-C-T	9.55657E-05	0	0.00015009	3	0	3	31392	11404	19988	0	0	0	472
21-27112774-A-G	6.36983E-05	8.76885E-05	5.0015E-05	2	1	1	31398	11404	19994	0	0	0	431
21-27112779-A-AT	0.001528176	0.004117029	5.0015E-05	48	47	1	31410	11416	19994	1	1	0	482
21-27112783-A-G	6.3674E-05	0.000175223	0	2	2	0	31410	11414	19996	0	0	0	187
21-27112792-C-T	0.000127356	0.000350447	0	4	4	0	31408	11414	19994	0	0	0	1
21-27112819-G-C	6.37024E-05	0.000175316	0	2	2	0	31396	11408	19988	0	0	0	228
21-27112823-T-C	0.000191046	0.000175223	0.00020008	6	2	4	31406	11414	19992	0	0	0	488
21-27112835-A-G	0.00933121	0.025512888	0.00010003	293	291	2	31400	11406	19994	5	5	0	150
21-27112848-G-A	3.18512E-05	8.76885E-05	0	1	1	0	31396	11404	19992	0	0	0	171
21-27112850-C-T	3.18451E-05	0	5.002E-05	1	0	1	31402	11410	19992	0	0	0	301
21-27112853-CAAAG-C	3.18613E-05	8.77039E-05	0	1	1	0	31386	11402	19984	0	0	0	107
21-27112855-A-G	6.3674E-05	0	0.00010001	2	0	2	31410	11412	19998	0	0	0	460
21-27112858-A-G	3.1837E-05	8.76271E-05	0	1	1	0	31410	11412	19998	0	0	0	231
21-27112858-A-T	3.1837E-05	8.76271E-05	0	1	1	0	31410	11412	19998	0	0	0	358
21-27112863-T-C	3.1837E-05	8.76117E-05	0	1	1	0	31410	11414	19996	0	0	0	318
21-27112871-T-C	3.18431E-05	8.76578E-05	0	1	1	0	31404	11408	19996	0	0	0	269
21-27112883-G-A	3.18471E-05	0	5.003E-05	1	0	1	31400	11412	19988	0	0	0	413
21-27112890-C-A	3.18552E-05	0	5.00551E-05	1	0	1	31392	11414	19978	0	0	0	161
21-27112912-A-G	0.003981906	0.010869565	5.004E-05	125	124	1	31392	11408	19984	0	0	0	234
21-27112930-T-C	3.18431E-05	8.76271E-05	0	1	1	0	31404	11412	19992	0	0	0	395
21-27112937-C-A	3.18654E-05	0	5.00551E-05	1	0	1	31382	11404	19978	0	0	0	146
21-27112968-A-C	0.000286551	0.000700894	5.0015E-05	9	8	1	31408	11414	19994	0	0	0	222
21-27113003-C-T	0.00047789	0.001314867	0	15	15	0	31388	11408	19980	0	0	0	260
21-27113008-G-GA	3.18857E-05	0	5.01002E-05	1	0	1	31362	11402	19960	0	0	0	486
21-27113030-T-A	3.1841E-05	0	5.0015E-05	1	0	1	31406	11412	19994	0	0	0	110
21-27113053-A-G	3.18431E-05	0	5.002E-05	1	0	1	31404	11412	19992	0	0	0	117
21-27113065-G-A	9.56023E-05	0.000263019	0	3	3	0	31380	11406	19974	0	0	0	317
21-27113098-A-G	0.011782689	0.032077125	0.00020008	370	366	4	31402	11410	19992	8	8	0	159
21-27113105-C-A	9.5584E-05	8.76732E-05	0.0001001	3	1	2	31386	11406	19980	0	0	0	223
21-27113105-C-T	0.001051424	0.002893214	0	33	33	0	31386	11406	19980	0	0	0	404
21-27113153-A-G	0.023057325	0.062938289	0.00030012	724	718	6	31400	11408	19992	28	28	0	65
21-27113154-T-C	3.1837E-05	0	5.001E-05	1	0	1	31410	11414	19996	0	0	0	414
21-27113196-T-C	0.00910538	0.024973712	5.0005E-05	286	285	1	31410	11412	19998	2	2	0	432
21-27113204-A-G	3.1837E-05	8.75964E-05	0	1	1	0	31410	11416	19994	0	0	0	205
21-27113217-A-G	3.1839E-05	0	5.0015E-05	1	0	1	31408	11414	19994	0	0	0	173
21-27113223-A-G	3.18451E-05	8.76578E-05	0	1	1	0	31402	11408	19994	0	0	0	462
21-27113253-T-C	0.007005477	0.018940723	0.0002	220	216	4	31404	11404	20000	4	4	0	441
21-27113264-T-C	3.18431E-05	8.76424E-05	0	1	1	0	31404	11410	19994	0	0	0	150
21-27113270-C-G	6.36983E-05	0	0.00010006	2	0	2	31398	11410	19988	0	0	0	124
21-27113291-A-G	6.36862E-05	0.000175285	0	2	2	0	31404	11410	19994	0	0	0	458
21-27113299-C-T	0.004171443	0.001227209	0.00585117	131	14	117	31404	11408	19996	1	0	1	218
21-27113325-T-A	3.18492E-05	8.76732E-05	0	1	1	0	31398	11406	19992	0	0	0	194
21-27113330-G-A	9.55353E-05	0.000263066	0	3	3	0	31402	11404	19998	0	0	0	280
21-27113333-A-G	0.001146351	0.000525947	0.0015003	36	6	30	31404	11408	19996	0	0	0	132
21-27113353-A-G	3.18329E-05	8.76117E-05	0	1	1	0	31414	11414	20000	0	0	0	347
21-27113363-G-C	6.36902E-05	0.000175285	0	2	2	0	31402	11410	19992	0	0	0	13
21-27113379-G-A	0.020034399	0.054357356	0.000450225	629	620	9	31396	11406	19990	19	19	0	315
21-27113386-C-T	3.18451E-05	8.76578E-05	0	1	1	0	31402	11408	19994	0	0	0	440
21-27113391-T-G	0.003502962	0.009381028	0.00015003	110	107	3	31402	11406	19996	1	1	0	451
21-27113399-A-G	3.18451E-05	8.76885E-05	0	1	1	0	31402	11404	19998	0	0	0	157
21-27113409-T-A	0.289835165	0.489170629	0.17632608	9073	5556	3517	31304	11358	19946	1748	1441	307	376
21-27113409-T-TA	6.38896E-05	0.000176087	0	2	2	0	31304	11358	19946	0	0	0	384
21-27113415-ATTAG-A	3.18573E-05	0	5.002E-05	1	0	1	31390	11398	19992	0	0	0	382
21-27113445-CTTTAT-C	3.18939E-05	0	5.00952E-05	1	0	1	31354	11392	19962	0	0	0	450
21-27113466-G-A	6.37267E-05	0	0.0001001	2	0	2	31384	11404	19980	0	0	0	444
21-27113477-C-T	3.18532E-05	0	5.0035E-05	1	0	1	31394	11408	19986	0	0	0	379
21-27113478-G-A	0.000191217	0.000175562	0.00020014	6	2	4	31378	11392	19986	0	0	0	294
21-27113501-C-T	0.009147702	0.024741183	0.0002503	287	282	5	31374	11398	19976	5	5	0	359
21-27113507-T-G	3.18431E-05	8.76271E-05	0	1	1	0	31404	11412	19992	0	0	0	305
21-27113513-A-G	3.18492E-05	8.76271E-05	0	1	1	0	31398	11412	19986	0	0	0	234
21-27113523-C-T	6.36943E-05	0.000175346	0	2	2	0	31400	11406	19994	0	0	0	200
21-27113537-CA-C	6.36862E-05	0	0.00010001	2	0	2	31404	11406	19998	0	0	0	485
21-27113555-C-A	3.18451E-05	0	5.0025E-05	1	0	1	31402	11412	19990	0	0	0	265
21-27113559-C-G	3.18552E-05	0	5.004E-05	1	0	1	31392	11408	19984	0	0	0	13
21-27113560-T-C	3.18735E-05	8.76885E-05	0	1	1	0	31374	11404	19970	0	0	0	419
21-27113562-C-T	9.56206E-05	0.000263204	0	3	3	0	31374	11398	19976	0	0	0	384
21-27113589-C-T	0.011642001	0.003334503	0.016386049	365	38	327	31352	11396	19956	4	0	4	385
21-27113591-C-T	0.000127551	0	0.000200341	4	0	4	31360	11394	19966	0	0	0	399
21-27113592-G-A	3.19081E-05	8.78272E-05	0	1	1	0	31340	11386	19954	0	0	0	2
21-27113594-G-A	3.1902E-05	0	5.01153E-05	1	0	1	31346	11392	19954	0	0	0	472
21-27113598-C-T	0.000127551	0.000351185	0	4	4	0	31360	11390	19970	0	0	0	390
21-27113632-A-G	3.19264E-05	0	5.01002E-05	1	0	1	31322	11362	19960	0	0	0	43
21-27113641-C-T	3.19061E-05	0	5.00902E-05	1	0	1	31342	11378	19964	0	0	0	384
21-27113642-G-A	9.57793E-05	0.00026362	0	3	3	0	31322	11380	19942	0	0	0	400
21-27113672-T-C	9.56206E-05	8.78426E-05	0.00010005	3	1	2	31374	11384	19990	0	0	0	439
21-27113698-G-A	6.37674E-05	0	0.00010012	2	0	2	31364	11388	19976	0	0	0	327
21-27113705-A-G	3.18735E-05	8.77963E-05	0	1	1	0	31374	11390	19984	0	0	0	167
21-27113715-G-A	0.000191156	0.000526039	0	6	6	0	31388	11406	19982	0	0	0	138
21-27113719-A-T	3.18593E-05	0	5.004E-05	1	0	1	31388	11404	19984	0	0	0	39
21-27113734-C-T	3.18939E-05	0	5.00751E-05	1	0	1	31354	11384	19970	0	0	0	49
21-27113736-C-T	6.37674E-05	0	0.00010011	2	0	2	31364	11386	19978	0	0	0	51
21-27113752-T-G	6.37755E-05	0	0.00010016	2	0	2	31360	11392	19968	0	0	0	74
21-27113756-A-G	3.19101E-05	8.78735E-05	0	1	1	0	31338	11380	19958	0	0	0	413
21-27113773-C-T	0.000926103	0.002462621	5.01404E-05	29	28	1	31314	11370	19944	0	0	0	146
21-27113777-C-G	3.19285E-05	8.80437E-05	0	1	1	0	31320	11358	19962	0	0	0	172
21-27113777-C-T	6.3857E-05	0	0.00010019	2	0	2	31320	11358	19962	0	0	0	49
21-27113782-C-T	3.19428E-05	8.80437E-05	0	1	1	0	31306	11358	19948	0	0	0	57
21-27113791-G-A	0.000736	0.000352734	0.000954294	23	4	19	31250	11340	19910	0	0	0	34
21-27113794-T-C	0.005366726	0.000880282	0.007922182	168	10	158	31304	11360	19944	1	0	1	241
21-27113805-T-G	3.19898E-05	0	5.01807E-05	1	0	1	31260	11332	19928	0	0	0	87
21-27113817-C-CT	0.007764571	0.001938668	0.011078805	243	22	221	31296	11348	19948	1	0	1	158
21-27113819-A-T	9.58589E-05	0.000264224	0	3	3	0	31296	11354	19942	0	0	0	173
21-27113823-C-T	3.1957E-05	8.80437E-05	0	1	1	0	31292	11358	19934	0	0	0	94
21-27113838-G-A	3.19489E-05	0	5.01505E-05	1	0	1	31300	11360	19940	0	0	0	260
21-27113885-AC-A	3.18796E-05	8.77963E-05	0	1	1	0	31368	11390	19978	0	0	0	342
21-27113889-A-T	3.18776E-05	0	5.0045E-05	1	0	1	31370	11388	19982	0	0	0	434
21-27113901-ACTC-A	3.18857E-05	8.78735E-05	0	1	1	0	31362	11380	19982	0	0	0	111
21-27113930-G-T	3.18573E-05	8.76885E-05	0	1	1	0	31390	11404	19986	0	0	0	182
21-27114027-A-G	3.18756E-05	0	5.00601E-05	1	0	1	31372	11396	19976	0	0	0	194
21-27114075-C-CT	3.18959E-05	8.77809E-05	0	1	1	0	31352	11392	19960	0	0	0	157
21-27114075-C-G	0.000127584	0.000263343	5.01002E-05	4	3	1	31352	11392	19960	0	0	0	235
21-27114076-T-A	0.001593168	0.000526316	0.002201761	50	6	44	31384	11400	19984	0	0	0	333
21-27114085-C-A	3.19224E-05	0	5.01857E-05	1	0	1	31326	11400	19926	0	0	0	43
21-27114093-A-C	3.18593E-05	0	5.00501E-05	1	0	1	31388	11408	19980	0	0	0	422
21-27114102-G-A	6.37511E-05	0	0.0001001	2	0	2	31372	11392	19980	0	0	0	231
21-27114104-G-A	0.000254988	0.000702124	0	8	8	0	31374	11394	19980	0	0	0	405
21-27114104-G-T	3.18735E-05	0	5.00501E-05	1	0	1	31374	11394	19980	0	0	0	302
21-27114107-T-C	9.55475E-05	0	0.00015009	3	0	3	31398	11410	19988	0	0	0	369
21-27114119-T-G	3.18431E-05	0	5.001E-05	1	0	1	31404	11408	19996	0	0	0	191
21-27114122-T-G	3.1837E-05	0	5.0005E-05	1	0	1	31410	11412	19998	0	0	0	358
21-27114126-C-G	0.000287283	8.79353E-05	0.000400882	9	1	8	31328	11372	19956	0	0	0	393
21-27114126-C-T	3.19203E-05	8.79353E-05	0	1	1	0	31328	11372	19956	0	0	0	225
21-27114180-A-G	3.1839E-05	0	5.0005E-05	1	0	1	31408	11410	19998	0	0	0	141
21-27114192-A-C	3.18492E-05	8.76732E-05	0	1	1	0	31398	11406	19992	0	0	0	383
21-27114242-G-T	3.18776E-05	8.76578E-05	0	1	1	0	31370	11408	19962	0	0	0	405
21-27114246-CTTTA-C	3.18796E-05	8.76424E-05	0	1	1	0	31368	11410	19958	0	0	0	201
21-27114247-T-C	3.18451E-05	8.76424E-05	0	1	1	0	31402	11410	19992	0	0	0	337
21-27114258-C-T	0.001688328	0.002718344	0.00110066	53	31	22	31392	11404	19988	0	0	0	232
21-27114282-C-T	6.37146E-05	0	0.00010007	2	0	2	31390	11404	19986	0	0	0	150
21-27114290-GT-G	3.18512E-05	0	5.0035E-05	1	0	1	31396	11410	19986	0	0	0	82
21-27114300-A-G	3.1841E-05	8.76424E-05	0	1	1	0	31406	11410	19996	0	0	0	99
21-27114325-A-G	3.1837E-05	0	0.00005	1	0	1	31410	11410	20000	0	0	0	41
21-27114356-A-C	3.1837E-05	8.76271E-05	0	1	1	0	31410	11412	19998	0	0	0	149
21-27114356-A-G	3.1837E-05	0	5.0005E-05	1	0	1	31410	11412	19998	0	0	0	215
21-27114390-T-G	3.1839E-05	8.76117E-05	0	1	1	0	31408	11414	19994	0	0	0	464
21-27114397-G-C	3.1835E-05	8.76117E-05	0	1	1	0	31412	11414	19998	0	0	0	253
21-27114398-G-T	3.1835E-05	0	0.00005	1	0	1	31412	11412	20000	0	0	0	441
21-27114400-C-T	3.18451E-05	8.76424E-05	0	1	1	0	31402	11410	19992	0	0	0	340
21-27114406-G-T	0.000159215	0	0.000250075	5	0	5	31404	11410	19994	0	0	0	493
21-27114410-T-A	9.55231E-05	0.000262927	0	3	3	0	31406	11410	19996	0	0	0	160
21-27114423-C-A	3.18573E-05	0	5.004E-05	1	0	1	31390	11406	19984	0	0	0	454
21-27114439-T-A	3.1841E-05	0	5.0005E-05	1	0	1	31406	11408	19998	0	0	0	35
21-27114442-G-A	3.18532E-05	8.77039E-05	0	1	1	0	31394	11402	19992	0	0	0	207
21-27114492-A-G	3.1837E-05	0	0.00005	1	0	1	31410	11410	20000	0	0	0	187
21-27114540-A-T	0.125	0	0.25	1	0	1	8	4	4	0	0	0	208
21-27114546-C-CA	1	1	1	31206	11382	19824	31206	11382	19824	15603	5691	9912	85
21-27114550-A-G	9.48137E-05	0.000269687	0	2	2	0	21094	7416	13678	0	0	0	392
21-27114557-A-G	0.000148588	0.000434028	0	1	1	0	6730	2304	4426	0	0	0	397
21-27114572-C-CA	1	1	1	31258	11408	19850	31258	11408	19850	15629	5704	9925	90
21-27114573-T-A	0.029411765	0.041666667	0	1	1	0	34	24	10	0	0	0	399
21-27114586-A-T	3.19877E-05	0	5.03271E-05	1	0	1	31262	11392	19870	0	0	0	1
21-27114596-A-C	6.38121E-05	0	0.000100281	2	0	2	31342	11398	19944	0	0	0	440
21-27114600-AAGT-A	0.000987639	0.002719775	0	31	31	0	31388	11398	19990	0	0	0	393
21-27114605-G-C	6.37186E-05	0	0.00010008	2	0	2	31388	11404	19984	0	0	0	191
21-27114621-A-G	0.02351217	0.064035088	0.00040024	738	730	8	31388	11400	19988	30	30	0	86
21-27114631-G-A	6.36943E-05	0.000175254	0	2	2	0	31400	11412	19988	0	0	0	231
21-27114639-G-C	3.19163E-05	8.79662E-05	0	1	1	0	31332	11368	19964	0	0	0	410
21-27114664-A-G	5.58847E-05	0.000171644	0	1	1	0	17894	5826	12068	0	0	0	225
21-27114684-A-G	0.125	0.5	0	1	1	0	8	2	6	0	0	0	74
21-27114686-A-AG	0.05	0.125	0	1	1	0	20	8	12	0	0	0	179
21-27114687-G-GA	0.99993633	0.999912388	0.999949995	31410	11413	19997	31412	11414	19998	15704	5706	9998	9
21-27114688-A-AG	0.0625	0	0.1	1	0	1	16	6	10	0	0	0	210
21-27114698-A-C	0.000191046	0	0.00030006	6	0	6	31406	11410	19996	0	0	0	139
21-27114749-G-A	3.18512E-05	8.76885E-05	0	1	1	0	31396	11404	19992	0	0	0	257
21-27114753-A-G	3.1841E-05	0	5.001E-05	1	0	1	31406	11410	19996	0	0	0	481
21-27114762-C-G	0.000477829	0.000350693	0.000550385	15	4	11	31392	11406	19986	0	0	0	482
21-27114779-A-G	3.1837E-05	8.76117E-05	0	1	1	0	31410	11414	19996	0	0	0	408
21-27114804-T-C	3.18593E-05	8.77039E-05	0	1	1	0	31388	11402	19986	0	0	0	176
21-27114863-A-G	3.18512E-05	0	5.002E-05	1	0	1	31396	11404	19992	0	0	0	141
21-27114866-C-T	0.040381183	0.109619098	0.000900811	1267	1249	18	31376	11394	19982	87	87	0	348
21-27114926-A-G	3.18573E-05	8.76271E-05	0	1	1	0	31390	11412	19978	0	0	0	474
21-27114934-G-A	6.37918E-05	0	0.000100241	2	0	2	31352	11400	19952	0	0	0	153
21-27114995-TG-T	3.21213E-05	0	5.04643E-05	1	0	1	31132	11316	19816	0	0	0	97
21-27115014-C-T	3.21812E-05	8.8433E-05	0	1	1	0	31074	11308	19766	0	0	0	452
21-27115016-G-A	0.000256328	0	0.000403104	8	0	8	31210	11364	19846	1	0	1	5
21-27115031-C-A	3.23666E-05	8.89205E-05	0	1	1	0	30896	11246	19650	0	0	0	268
21-27115035-G-A	3.25182E-05	0	5.10777E-05	1	0	1	30752	11174	19578	0	0	0	370
21-27115070-C-A	0.000900971	0.000597848	0.001097341	23	6	17	25528	10036	15492	0	0	0	171
21-27115070-CA-C	0.315418364	0.488740534	0.203137103	8052	4905	3147	25528	10036	15492	1460	1230	230	108
21-27115070-CAA-C	0.000156691	9.96413E-05	0.000193648	4	1	3	25528	10036	15492	0	0	0	198
21-27115070-CAAA-C	0.659236916	0.472299721	0.780338239	16829	4740	12089	25528	10036	15492	5792	1160	4632	182
21-27115070-CAAAA-C	7.83453E-05	9.96413E-05	6.45494E-05	2	1	1	25528	10036	15492	0	0	0	208
21-27115077-A-G	0.000707259	0.00194072	0	22	22	0	31106	11336	19770	0	0	0	231
21-27115083-A-C	0.000772201	0.002117896	0	24	24	0	31080	11332	19748	0	0	0	209
21-27115122-A-G	3.23792E-05	0	5.10204E-05	1	0	1	30884	11284	19600	0	0	0	434
21-27115124-T-G	6.43252E-05	0.000176398	0	2	2	0	31092	11338	19754	0	0	0	22
21-27115129-A-C	3.24971E-05	0	5.12453E-05	1	0	1	30772	11258	19514	0	0	0	279
21-27115142-A-G	3.25267E-05	0	5.12978E-05	1	0	1	30744	11250	19494	0	0	0	380
21-27115155-C-G	3.21688E-05	8.82145E-05	0	1	1	0	31086	11336	19750	0	0	0	223
21-27115172-G-A	3.21564E-05	8.81523E-05	0	1	1	0	31098	11344	19754	0	0	0	105
21-27115195-C-G	3.23625E-05	0	5.10256E-05	1	0	1	30900	11302	19598	0	0	0	208
21-27115206-T-C	6.46287E-05	0.000176897	0	2	2	0	30946	11306	19640	0	0	0	287
21-27115218-T-C	3.23562E-05	0	5.10412E-05	1	0	1	30906	11314	19592	0	0	0	131
21-27115226-A-G	3.24149E-05	0	5.10569E-05	1	0	1	30850	11264	19586	0	0	0	230
21-27115226-AGGACAAGGTGC-A	3.24149E-05	8.87784E-05	0	1	1	0	30850	11264	19586	0	0	0	347
21-27115237-C-T	3.57066E-05	0	5.74383E-05	1	0	1	28006	10596	17410	0	0	0	374
21-27115238-G-A	0.000137466	0.00036785	0	4	4	0	29098	10874	18224	0	0	0	148
21-27115243-C-A	0.010403917	0.002708868	0.016191293	170	19	151	16340	7014	9326	0	0	0	307
21-27115243-C-CA	0.006670747	0.002281152	0.009972121	109	16	93	16340	7014	9326	0	0	0	435
21-27115243-C-CAA	0.000734394	0.001140576	0.000428908	12	8	4	16340	7014	9326	0	0	0	485
21-27115243-CA-C	0.032252142	0.018676932	0.042461934	527	131	396	16340	7014	9326	1	1	0	449
21-27115243-CAA-C	0.043206854	0.090248075	0.007827579	706	633	73	16340	7014	9326	26	26	0	289
21-27115243-CAAA-C	0.002264382	0.001853436	0.002573451	37	13	24	16340	7014	9326	0	0	0	323
21-27115249-A-G	3.19816E-05	0	5.03119E-05	1	0	1	31268	11392	19876	0	0	0	472
21-27115250-A-G	3.19836E-05	8.77809E-05	0	1	1	0	31266	11392	19874	0	0	0	498
21-27115264-A-G	0.000160082	0.000439522	0	5	5	0	31234	11376	19858	0	0	0	78
21-27115266-A-G	3.2144E-05	0	5.0551E-05	1	0	1	31110	11328	19782	0	0	0	229
21-27115267-T-A	0.000192221	0.000528634	0	6	6	0	31214	11350	19864	0	0	0	417
21-27115280-A-G	3.23981E-05	0	5.10934E-05	1	0	1	30866	11294	19572	0	0	0	203
21-27115298-C-G	3.20307E-05	8.80127E-05	0	1	1	0	31220	11362	19858	0	0	0	274
21-27115302-G-A	0.009070005	0.024841994	5.02008E-05	284	283	1	31312	11392	19920	2	2	0	196
21-27115309-T-C	0.001182033	0.003247893	0	37	37	0	31302	11392	19910	0	0	0	20
21-27115310-T-TA	0.000351191	0.000877655	5.01807E-05	11	10	1	31322	11394	19928	0	0	0	102
21-27115321-A-C	6.391E-05	0.000175439	0	2	2	0	31294	11400	19894	0	0	0	115
21-27115383-A-G	3.18512E-05	8.76271E-05	0	1	1	0	31396	11412	19984	0	0	0	268
21-27115384-G-T	3.18512E-05	0	5.0035E-05	1	0	1	31396	11410	19986	0	0	0	17
21-27115394-G-A	3.18613E-05	0	5.00501E-05	1	0	1	31386	11406	19980	0	0	0	328
21-27115402-G-A	0.001210808	0.003330996	0	38	38	0	31384	11408	19976	0	0	0	459
21-27115404-G-A	3.18573E-05	0	5.00501E-05	1	0	1	31390	11410	19980	0	0	0	223
21-27115407-T-G	3.18451E-05	8.76424E-05	0	1	1	0	31402	11410	19992	0	0	0	34
21-27115408-G-A	6.37186E-05	0.000175377	0	2	2	0	31388	11404	19984	0	0	0	387
21-27115409-C-T	6.37064E-05	0.000175346	0	2	2	0	31394	11406	19988	0	0	0	156
21-27115410-G-A	3.18552E-05	0	5.0045E-05	1	0	1	31392	11410	19982	0	0	0	43
21-27115419-C-T	0.000222973	0.000613389	0	7	7	0	31394	11412	19982	0	0	0	8
21-27115437-C-T	3.18492E-05	0	5.0035E-05	1	0	1	31398	11412	19986	0	0	0	221
21-27115439-A-G	3.18471E-05	0	5.002E-05	1	0	1	31400	11408	19992	0	0	0	307
21-27115441-A-G	3.18552E-05	8.76885E-05	0	1	1	0	31392	11404	19988	0	0	0	218
21-27115456-A-G	0.002037697	0.005520505	5.001E-05	64	63	1	31408	11412	19996	2	2	0	39
21-27115464-ACT-A	3.19101E-05	8.78272E-05	0	1	1	0	31338	11386	19952	0	0	0	416
21-27115471-C-T	3.18573E-05	0	5.00501E-05	1	0	1	31390	11410	19980	0	0	0	383
21-27115479-G-A	0.001783326	0.004907115	0	56	56	0	31402	11412	19990	0	0	0	220
21-27115490-G-T	3.18492E-05	0	5.0035E-05	1	0	1	31398	11412	19986	0	0	0	415
21-27115493-A-T	6.36943E-05	0.000175285	0	2	2	0	31400	11410	19990	0	0	0	99
21-27115522-A-C	3.18492E-05	8.76732E-05	0	1	1	0	31398	11406	19992	0	0	0	449
21-27115530-A-G	0.000318492	8.76578E-05	0.000450225	10	1	9	31398	11408	19990	0	0	0	243
21-27115532-T-G	3.18492E-05	0	5.0025E-05	1	0	1	31398	11408	19990	0	0	0	30
21-27115547-C-T	3.18532E-05	8.76578E-05	0	1	1	0	31394	11408	19986	0	0	0	141
21-27115556-C-CT	3.18532E-05	8.76424E-05	0	1	1	0	31394	11410	19984	0	0	0	74
21-27115569-T-C	3.18492E-05	8.76271E-05	0	1	1	0	31398	11412	19986	0	0	0	77
21-27115573-A-G	9.55718E-05	0	0.000150135	3	0	3	31390	11408	19982	0	0	0	130
21-27115582-A-G	9.55414E-05	0	0.00015009	3	0	3	31400	11412	19988	0	0	0	135
21-27115596-T-C	0.002707869	0.000350754	0.004052837	85	4	81	31390	11404	19986	0	0	0	225
21-27115608-C-T	3.18532E-05	8.76424E-05	0	1	1	0	31394	11410	19984	0	0	0	166
21-27115613-A-G	3.18552E-05	0	5.003E-05	1	0	1	31392	11404	19988	0	0	0	124
21-27115620-C-T	3.18552E-05	0	5.004E-05	1	0	1	31392	11408	19984	0	0	0	348
21-27115638-G-A	9.55597E-05	0.000175316	5.0035E-05	3	2	1	31394	11408	19986	0	0	0	466
21-27115646-T-C	0.014718063	0.039912281	0.000350175	462	455	7	31390	11400	19990	14	14	0	434
21-27115673-G-A	0.289085452	0.487315011	0.176367461	9053	5532	3521	31316	11352	19964	1740	1431	309	180
21-27115678-C-T	3.18613E-05	8.76885E-05	0	1	1	0	31386	11404	19982	0	0	0	480
21-27115689-T-C	0.277323539	0.455234403	0.176184751	8683	5166	3517	31310	11348	19962	1528	1222	306	89
21-27115699-A-G	0.000223015	0.000175346	0.000250225	7	2	5	31388	11406	19982	0	0	0	480
21-27115701-A-G	3.18532E-05	0	5.003E-05	1	0	1	31394	11406	19988	0	0	0	445
21-27115760-C-G	3.18756E-05	8.77347E-05	0	1	1	0	31372	11398	19974	0	0	0	323
21-27115768-G-C	3.18674E-05	8.77193E-05	0	1	1	0	31380	11400	19980	0	0	0	62
21-27115774-C-T	3.18674E-05	0	5.00551E-05	1	0	1	31380	11402	19978	0	0	0	314
21-27115777-G-C	9.56023E-05	0.000263204	0	3	3	0	31380	11398	19982	0	0	0	387
21-27115785-G-A	0.253806295	0.390944327	0.17562274	7935	4438	3497	31264	11352	19912	1189	884	305	358
21-27115790-A-G	0.001243147	0.003419853	0	39	39	0	31372	11404	19968	1	1	0	468
21-27115837-G-A	3.20904E-05	8.81057E-05	0	1	1	0	31162	11350	19812	0	0	0	263
21-27115847-C-T	6.51848E-05	0.00017854	0	2	2	0	30682	11202	19480	0	0	0	36
21-27115848-G-A	0.002375297	0.006525573	0	74	74	0	31154	11340	19814	0	0	0	46
21-27115860-T-C	3.20328E-05	0	5.03931E-05	1	0	1	31218	11374	19844	0	0	0	253
21-27115889-GATC-G	3.27375E-05	0	5.11195E-05	1	0	1	30546	10984	19562	0	0	0	272
21-27115895-C-CT	0.000540496	0.001357277	0	13	13	0	24052	9578	14474	0	0	0	366
21-27115895-C-CTT	0.026484284	0.050010441	0.010916125	637	479	158	24052	9578	14474	15	15	0	52
21-27115895-CT-C	0.001621487	0.001252871	0.001865414	39	12	27	24052	9578	14474	0	0	0	430
21-27115895-CTT-C	0.184683186	0.236688244	0.150269449	4442	2267	2175	24052	9578	14474	270	218	52	83
21-27115895-CTTTTT-C	0.00024946	0	0.000414536	6	0	6	24052	9578	14474	0	0	0	243
21-27115921-TG-T	0.002410336	0.00653018	5.05459E-05	75	74	1	31116	11332	19784	1	1	0	279
21-27115925-A-G	3.36474E-05	9.00414E-05	0	1	1	0	29720	11106	18614	0	0	0	485
21-27115926-C-G	3.42536E-05	0	5.48607E-05	1	0	1	29194	10966	18228	0	0	0	407
21-27115926-C-T	3.42536E-05	0	5.48607E-05	1	0	1	29194	10966	18228	0	0	0	38
21-27115947-C-T	3.24465E-05	8.86368E-05	0	1	1	0	30820	11282	19538	0	0	0	356
21-27115952-T-A	0.001662936	0	0.002617538	52	0	52	31270	11404	19866	0	0	0	269
21-27115964-C-T	3.25098E-05	8.90313E-05	0	1	1	0	30760	11232	19528	0	0	0	273
21-27115967-T-C	0.000320143	0.000878117	0	10	10	0	31236	11388	19848	0	0	0	7
21-27115978-T-A	6.39754E-05	0	0.000100675	2	0	2	31262	11396	19866	0	0	0	274
21-27115979-A-T	0.000127934	0.000263296	5.03221E-05	4	3	1	31266	11394	19872	0	0	0	39
21-27116073-G-T	3.21275E-05	0	5.06432E-05	1	0	1	31126	11380	19746	0	0	0	416
21-27116074-A-T	3.1953E-05	0	5.02664E-05	1	0	1	31296	11402	19894	0	0	0	30
21-27116092-A-T	3.1957E-05	0	5.02614E-05	1	0	1	31292	11396	19896	0	0	0	85
21-27116133-G-A	0.000960738	0.000615764	0.001158223	30	7	23	31226	11368	19858	0	0	0	134
21-27116145-C-T	9.63515E-05	0.000264131	0	3	3	0	31136	11358	19778	0	0	0	320
21-27116146-G-A	0.002413438	0.006527876	5.06586E-05	75	74	1	31076	11336	19740	1	1	0	257
21-27116161-A-G	0.000032	8.79198E-05	0	1	1	0	31250	11374	19876	0	0	0	357
21-27116172-GCCAA-G	3.21585E-05	0	5.06175E-05	1	0	1	31096	11340	19756	0	0	0	65
21-27116178-A-AT	3.20533E-05	0	5.04337E-05	1	0	1	31198	11370	19828	0	0	0	491
21-27116181-C-G	3.22123E-05	0	5.0746E-05	1	0	1	31044	11338	19706	0	0	0	43
21-27116186-C-G	6.44205E-05	0	0.000101451	2	0	2	31046	11332	19714	0	0	0	218
21-27116188-C-T	3.22227E-05	8.83236E-05	0	1	1	0	31034	11322	19712	0	0	0	3
21-27116198-T-TA	3.21978E-05	0	5.06997E-05	1	0	1	31058	11334	19724	0	0	0	92
21-27116209-G-A	3.20472E-05	0	5.04185E-05	1	0	1	31204	11370	19834	0	0	0	234
21-27116211-T-G	0.000192234	0.000526963	0	6	6	0	31212	11386	19826	0	0	0	139
21-27116224-G-A	3.21626E-05	8.81368E-05	0	1	1	0	31092	11346	19746	0	0	0	158
21-27116228-G-A	3.20492E-05	8.79507E-05	0	1	1	0	31202	11370	19832	0	0	0	429
21-27116267-A-G	3.22123E-05	0	5.07048E-05	1	0	1	31044	11322	19722	0	0	0	230
21-27116279-C-T	6.53083E-05	0	0.000103018	2	0	2	30624	11210	19414	0	0	0	34
21-27116286-C-T	0.000200133	0.000543478	0	6	6	0	29980	11040	18940	0	0	0	45
21-27116287-G-A	0.000365935	0.000899604	5.27872E-05	11	10	1	30060	11116	18944	0	0	0	124
21-27116294-G-A	3.27182E-05	8.92061E-05	0	1	1	0	30564	11210	19354	0	0	0	209
21-27116309-C-G	3.38547E-05	0	5.36942E-05	1	0	1	29538	10914	18624	0	0	0	486
21-27116316-C-T	3.39559E-05	9.16926E-05	0	1	1	0	29450	10906	18544	0	0	0	444
21-27116320-A-C	0.088730659	0.129643457	0.065034058	2592	1389	1203	29212	10714	18498	141	104	37	207
21-27116353-C-A	0.01528431	0.033634538	0.001675354	143	134	9	9356	3984	5372	8	7	1	170
21-27116353-C-CA	0.05793074	0.102660643	0.024758004	542	409	133	9356	3984	5372	39	36	3	247
21-27116353-C-CAA	0.389055152	0.393574297	0.385703649	3640	1568	2072	9356	3984	5372	660	302	358	42
21-27116353-C-CAAA	0.005557931	0.013052209	0	52	52	0	9356	3984	5372	2	2	0	204
21-27116353-C-CAAAA	0.044035913	0.014558233	0.065897245	412	58	354	9356	3984	5372	4	0	4	348
21-27116353-CA-C	0.067977768	0.051706827	0.080044676	636	206	430	9356	3984	5372	0	0	0	435
21-27116364-A-C	0.000191278	0.000244678	0.000166982	5	2	3	26140	8174	17966	0	0	0	459
21-27116368-A-C	7.72499E-05	0.000248942	0	2	2	0	25890	8034	17856	0	0	0	384
21-27116370-A-AAAAAAAAC	0.0001146	0.000362932	0	3	3	0	26178	8266	17912	0	0	0	314
21-27116370-A-AAC	0.008786004	0.027824825	0	230	230	0	26178	8266	17912	2	2	0	397
21-27116370-A-AC	3.82E-05	0.000120977	0	1	1	0	26178	8266	17912	0	0	0	311
21-27116370-A-C	3.82E-05	0.000120977	0	1	1	0	26178	8266	17912	0	0	0	14
21-27116380-C-CG	0.000121655	0.00039693	0	3	3	0	24660	7558	17102	0	0	0	408
21-27116381-A-AC	0.281835856	0.481294426	0.164090106	8118	5146	2972	28804	10692	18112	1583	1321	262	182
21-27116381-A-AT	0.000104152	0.000280584	0	3	3	0	28804	10692	18112	0	0	0	97
21-27116381-A-T	3.47174E-05	9.35279E-05	0	1	1	0	28804	10692	18112	0	0	0	460
21-27116383-G-A	3.41623E-05	0	5.40132E-05	1	0	1	29272	10758	18514	0	0	0	482
21-27116393-A-G	0.000296599	0.000804577	0	9	9	0	30344	11186	19158	0	0	0	144
21-27116397-G-A	6.77094E-05	0.000182349	0	2	2	0	29538	10968	18570	0	0	0	323
21-27116410-GCTTA-G	6.69658E-05	9.0269E-05	5.32255E-05	2	1	1	29866	11078	18788	0	0	0	255
21-27116421-G-A	3.47439E-05	0	5.55432E-05	1	0	1	28782	10778	18004	0	0	0	234
21-27116421-GT-G	0.000243208	0	0.000388802	7	0	7	28782	10778	18004	0	0	0	392
21-27116425-T-C	3.22206E-05	8.79198E-05	0	1	1	0	31036	11374	19662	0	0	0	133
21-27116430-T-TA	9.66059E-05	0.000263667	0	3	3	0	31054	11378	19676	0	0	0	199
21-27116441-A-G	3.21958E-05	0	5.07975E-05	1	0	1	31060	11374	19686	0	0	0	339
21-27116445-C-T	3.30929E-05	9.03016E-05	0	1	1	0	30218	11074	19144	0	0	0	3
21-27116446-A-G	3.22186E-05	0	5.07975E-05	1	0	1	31038	11352	19686	0	0	0	320
21-27116472-G-A	3.22977E-05	0	5.09269E-05	1	0	1	30962	11326	19636	0	0	0	494
21-27116483-A-G	3.21069E-05	0	5.05715E-05	1	0	1	31146	11372	19774	0	0	0	395
21-27116492-G-T	3.21172E-05	8.80902E-05	0	1	1	0	31136	11352	19784	0	0	0	30
21-27116507-T-C	3.20225E-05	0	5.0388E-05	1	0	1	31228	11382	19846	0	0	0	394
21-27116525-A-C	3.19611E-05	8.77809E-05	0	1	1	0	31288	11392	19896	0	0	0	37
21-27116532-A-G	0.00012818	8.79972E-05	0.000151194	4	1	3	31206	11364	19842	0	0	0	467
21-27116545-G-A	0.001277302	0.003245045	0.000150648	40	37	3	31316	11402	19914	0	0	0	478
21-27116549-T-C	0.000223628	0.000526039	5.02614E-05	7	6	1	31302	11406	19896	0	0	0	218
21-27116553-A-C	0.00012773	0	0.000200904	4	0	4	31316	11406	19910	0	0	0	133
21-27116558-C-T	0.000127869	0.000263158	5.02968E-05	4	3	1	31282	11400	19882	0	0	0	286
21-27116564-A-G	3.19326E-05	0	5.0221E-05	1	0	1	31316	11404	19912	0	0	0	21
21-27116571-G-C	3.1953E-05	8.77347E-05	0	1	1	0	31296	11398	19898	0	0	0	286
21-27116573-T-C	3.20451E-05	0	5.03981E-05	1	0	1	31206	11364	19842	0	0	0	59
21-27116606-C-T	6.42426E-05	0	0.000101112	2	0	2	31132	11352	19780	0	0	0	242
21-27116622-T-C	3.20513E-05	8.7858E-05	0	1	1	0	31200	11382	19818	0	0	0	187
21-27116622-T-G	3.20513E-05	0	5.04592E-05	1	0	1	31200	11382	19818	0	0	0	492
21-27116626-G-A	3.20554E-05	0	5.04541E-05	1	0	1	31196	11376	19820	0	0	0	127
21-27116633-T-C	3.20472E-05	0	5.04643E-05	1	0	1	31204	11388	19816	0	0	0	21
21-27116671-A-G	3.19448E-05	0	5.02462E-05	1	0	1	31304	11402	19902	0	0	0	301
21-27116681-A-G	6.38814E-05	0.000175408	0	2	2	0	31308	11402	19906	0	0	0	351
21-27116698-A-G	6.37959E-05	0.000175285	0	2	2	0	31350	11410	19940	0	0	0	319
21-27116730-A-G	3.18857E-05	0	5.01253E-05	1	0	1	31362	11412	19950	0	0	0	382
21-27116747-AT-A	3.18756E-05	8.76732E-05	0	1	1	0	31372	11406	19966	0	0	0	472
21-27116781-T-G	3.18613E-05	0	5.00651E-05	1	0	1	31386	11412	19974	0	0	0	298
21-27116791-A-G	6.37105E-05	0.000175285	0	2	2	0	31392	11410	19982	0	0	0	258
21-27116802-A-G	0.000923626	0.000263019	0.00130052	29	3	26	31398	11406	19992	0	0	0	139
21-27116804-TA-T	0.00041425	0.001139751	0	13	13	0	31382	11406	19976	0	0	0	269
21-27116824-A-AT	9.56328E-05	0	0.000150255	3	0	3	31370	11404	19966	0	0	0	108
21-27116837-T-C	3.18776E-05	0	5.00902E-05	1	0	1	31370	11406	19964	0	0	0	218
21-27116873-A-G	3.18796E-05	0	5.00952E-05	1	0	1	31368	11406	19962	0	0	0	421
21-27116878-G-T	0.001275185	0.003506926	0	40	40	0	31368	11406	19962	0	0	0	50
21-27116897-AAG-A	3.18695E-05	8.76732E-05	0	1	1	0	31378	11406	19972	0	0	0	141
21-27116905-T-C	0.00019129	0.000526131	0	6	6	0	31366	11404	19962	0	0	0	128
21-27116937-T-C	3.18532E-05	0	5.0045E-05	1	0	1	31394	11412	19982	0	0	0	336
21-27116940-A-G	0.00022293	0.000613604	0	7	7	0	31400	11408	19992	0	0	0	153
21-27116946-A-G	3.18512E-05	0	5.002E-05	1	0	1	31396	11404	19992	0	0	0	308
21-27116950-G-T	3.18552E-05	0	5.004E-05	1	0	1	31392	11408	19984	0	0	0	113
21-27116955-A-G	6.37146E-05	0	0.00010009	2	0	2	31390	11408	19982	0	0	0	497
21-27116993-T-C	3.21295E-05	0	5.03373E-05	1	0	1	31124	11258	19866	0	0	0	47
21-27116998-A-AT	3.30207E-05	0	5.22139E-05	1	0	1	30284	11132	19152	0	0	0	250
21-27116998-A-G	0.000198124	8.98311E-05	0.000261069	6	1	5	30284	11132	19152	0	0	0	78
21-27116998-AT-A	0.085853916	0.110312612	0.071637427	2600	1228	1372	30284	11132	19152	106	66	40	118
21-27117012-C-CGTT	3.22227E-05	0	5.08027E-05	1	0	1	31034	11350	19684	0	0	0	193
21-27117013-G-A	9.6463E-05	0.000264085	0	3	3	0	31100	11360	19740	0	0	0	112
21-27117019-C-T	0.000127608	0	0.000200582	4	0	4	31346	11404	19942	0	0	0	184
21-27117077-A-G	3.18532E-05	0	5.0035E-05	1	0	1	31394	11408	19986	0	0	0	476
21-27117094-ATCTT-A	9.56877E-05	0.000263066	0	3	3	0	31352	11404	19948	0	0	0	378
21-27117096-C-T	3.19877E-05	8.79817E-05	0	1	1	0	31262	11366	19896	0	0	0	323
21-27117100-C-CT	0.000129727	0.000353732	0	4	4	0	30834	11308	19526	0	0	0	35
21-27117102-T-C	0.01576591	0.006504923	0.021061627	493	74	419	31270	11376	19894	6	0	6	224
21-27117104-T-C	3.18613E-05	8.76271E-05	0	1	1	0	31386	11412	19974	0	0	0	50
21-27117109-T-A	3.18552E-05	8.76424E-05	0	1	1	0	31392	11410	19982	0	0	0	244
21-27117109-T-TA	0.000191131	0.000525855	0	6	6	0	31392	11410	19982	0	0	0	270
21-27117117-G-A	3.20205E-05	0	5.03525E-05	1	0	1	31230	11370	19860	0	0	0	461
21-27117122-G-A	3.19122E-05	8.78117E-05	0	1	1	0	31336	11388	19948	0	0	0	344
21-27117135-A-G	3.18532E-05	8.76424E-05	0	1	1	0	31394	11410	19984	0	0	0	140
21-27117179-T-C	0.000509587	8.76424E-05	0.00075045	16	1	15	31398	11410	19988	0	0	0	421
21-27117179-T-G	0.005159564	0.01375986	0.00025015	162	157	5	31398	11410	19988	0	0	0	205
21-27117186-A-G	3.18573E-05	8.76732E-05	0	1	1	0	31390	11406	19984	0	0	0	380
21-27117194-T-G	0.000127405	0	0.00020016	4	0	4	31396	11412	19984	0	0	0	349
21-27117207-A-G	0.000127413	0.00035057	0	4	4	0	31394	11410	19984	0	0	0	296
21-27117229-ATAATG-A	6.36943E-05	0	0.00010004	2	0	2	31400	11408	19992	0	0	0	119
21-27117237-T-C	6.36943E-05	8.76424E-05	5.0025E-05	2	1	1	31400	11410	19990	0	0	0	472
21-27117240-G-C	3.18756E-05	8.76732E-05	0	1	1	0	31372	11406	19966	0	0	0	32
21-27117242-A-G	3.18492E-05	0	5.002E-05	1	0	1	31398	11406	19992	0	0	0	259
21-27117244-T-G	3.18471E-05	8.76732E-05	0	1	1	0	31400	11406	19994	0	0	0	462
21-27117271-A-G	3.18573E-05	8.77039E-05	0	1	1	0	31390	11402	19988	0	0	0	335
21-27117272-T-C	3.18512E-05	8.76732E-05	0	1	1	0	31396	11406	19990	0	0	0	248
21-27117273-G-T	3.18695E-05	0	5.00551E-05	1	0	1	31378	11400	19978	0	0	0	442
21-27117280-C-T	3.18613E-05	8.77193E-05	0	1	1	0	31386	11400	19986	0	0	0	318
21-27117297-A-G	3.18431E-05	0	5.0025E-05	1	0	1	31404	11414	19990	0	0	0	88
21-27117318-T-G	0.000222887	0.000613174	0	7	7	0	31406	11416	19990	0	0	0	196
21-27117336-C-G	6.36902E-05	0.000175193	0	2	2	0	31402	11416	19986	0	0	0	2
21-27117340-G-A	6.37105E-05	8.76424E-05	5.0045E-05	2	1	1	31392	11410	19982	0	0	0	40
21-27117363-A-G	0.000159357	0.00035057	5.00851E-05	5	4	1	31376	11410	19966	0	0	0	157
21-27117379-AGCCT-A	0.037052377	0.008149317	0.053564277	1163	93	1070	31388	11412	19976	28	0	28	438
21-27117403-A-T	0.000127356	0	0.00020004	4	0	4	31408	11412	19996	0	0	0	245
21-27117433-T-C	3.1839E-05	8.76117E-05	0	1	1	0	31408	11414	19994	0	0	0	328
21-27117445-G-A	0.00054147	0.001489921	0	17	17	0	31396	11410	19986	0	0	0	464
21-27117452-T-C	6.36821E-05	0	0.00010003	2	0	2	31406	11412	19994	0	0	0	58
21-27117475-C-T	3.18573E-05	8.76271E-05	0	1	1	0	31390	11412	19978	0	0	0	318
21-27117494-G-C	6.36902E-05	0.000175285	0	2	2	0	31402	11410	19992	0	0	0	155
21-27117536-C-T	0.000127413	0.000175346	0.00010006	4	2	2	31394	11406	19988	0	0	0	276
21-27117541-C-T	0.000191071	0.000525947	0	6	6	0	31402	11408	19994	0	0	0	213
21-27117542-G-A	0.001528955	0.004033672	0.00010005	48	46	2	31394	11404	19990	0	0	0	117
21-27117563-G-A	3.18431E-05	0	5.0015E-05	1	0	1	31404	11410	19994	0	0	0	84
21-27117578-T-C	3.18451E-05	8.76424E-05	0	1	1	0	31402	11410	19992	0	0	0	154
21-27117590-C-G	3.18431E-05	8.76424E-05	0	1	1	0	31404	11410	19994	0	0	0	68
21-27117603-C-T	3.18492E-05	0	5.003E-05	1	0	1	31398	11410	19988	0	0	0	197
21-27117638-T-C	3.1839E-05	8.76271E-05	0	1	1	0	31408	11412	19996	0	0	0	272
21-27117694-G-A	3.18918E-05	0	5.01253E-05	1	0	1	31356	11406	19950	0	0	0	392
21-27117756-A-G	3.18837E-05	0	5.01203E-05	1	0	1	31364	11412	19952	0	0	0	66
21-27117777-C-T	0.001593473	0.004383658	0	50	50	0	31378	11406	19972	0	0	0	61
21-27117809-T-C	3.18878E-05	0	5.01102E-05	1	0	1	31360	11404	19956	0	0	0	284
21-27117810-A-G	3.18471E-05	8.76424E-05	0	1	1	0	31400	11410	19990	0	0	0	287
21-27117824-G-A	3.18715E-05	8.76885E-05	0	1	1	0	31376	11404	19972	0	0	0	266
21-27117838-A-G	3.18654E-05	0	5.00551E-05	1	0	1	31382	11404	19978	0	0	0	21
21-27117849-T-C	9.55901E-05	0.000175377	5.00501E-05	3	2	1	31384	11404	19980	0	0	0	422
21-27117879-A-G	0.093419207	0.072492987	0.10538184	2930	827	2103	31364	11408	19956	182	88	94	124
21-27117887-G-GT	3.19081E-05	0	5.01555E-05	1	0	1	31340	11402	19938	0	0	0	274
21-27117896-T-C	0.000350497	0.000876271	5.00701E-05	11	10	1	31384	11412	19972	0	0	0	334
21-27117912-C-T	3.18776E-05	0	5.00801E-05	1	0	1	31370	11402	19968	0	0	0	53
21-27117913-G-A	3.18878E-05	0	5.01002E-05	1	0	1	31360	11400	19960	0	0	0	389
21-27117924-A-G	3.18451E-05	8.75964E-05	0	1	1	0	31402	11416	19986	0	0	0	186
21-27117970-CCATT-C	3.18735E-05	0	5.00851E-05	1	0	1	31374	11408	19966	0	0	0	480
21-27118023-C-A	0.006406579	0.017528484	5.00902E-05	201	200	1	31374	11410	19964	1	1	0	164
21-27118024-G-A	9.56999E-05	0.000263066	0	3	3	0	31348	11404	19944	0	0	0	97
21-27118030-T-C	3.18654E-05	0	5.00701E-05	1	0	1	31382	11410	19972	0	0	0	231
21-27118046-C-G	3.18939E-05	8.76578E-05	0	1	1	0	31354	11408	19946	0	0	0	135
21-27118057-T-A	0.039910743	0.108283608	0.000901172	1252	1234	18	31370	11396	19974	83	83	0	441
21-27118065-T-G	6.37227E-05	0	0.00010012	2	0	2	31386	11410	19976	0	0	0	340
21-27118091-A-G	3.18857E-05	0	5.01102E-05	1	0	1	31362	11406	19956	0	0	0	219
21-27118108-A-G	3.18715E-05	0	5.00701E-05	1	0	1	31376	11404	19972	0	0	0	180
21-27118122-G-A	3.1904E-05	8.77501E-05	0	1	1	0	31344	11396	19948	0	0	0	202
21-27118133-T-G	3.18735E-05	8.76424E-05	0	1	1	0	31374	11410	19964	0	0	0	170
21-27118140-A-G	0.00366756	0.009908804	0.000100241	115	113	2	31356	11404	19952	5	5	0	486
21-27118150-T-C	3.18756E-05	8.76732E-05	0	1	1	0	31372	11406	19966	0	0	0	51
21-27118171-T-C	3.18552E-05	8.75964E-05	0	1	1	0	31392	11416	19976	0	0	0	101
21-27118188-G-A	3.18573E-05	8.76578E-05	0	1	1	0	31390	11408	19982	0	0	0	241
21-27118201-C-T	0.000159266	0.000350508	5.0045E-05	5	4	1	31394	11412	19982	0	0	0	158
21-27118207-G-A	6.37349E-05	0.000175346	0	2	2	0	31380	11406	19974	0	0	0	332
21-27118229-T-G	0.002834575	0.007711181	5.0035E-05	89	88	1	31398	11412	19986	0	0	0	490
21-27118251-T-C	3.18613E-05	8.76578E-05	0	1	1	0	31386	11408	19978	0	0	0	139
21-27118268-A-T	0.000414224	0.001139152	0	13	13	0	31384	11412	19972	0	0	0	149
21-27118271-G-A	3.19509E-05	8.7858E-05	0	1	1	0	31298	11382	19916	0	0	0	232
21-27118293-CAT-C	9.58466E-05	0	0.000150784	3	0	3	31300	11404	19896	0	0	0	395
21-27118320-C-CT	3.44021E-05	9.1878E-05	0	1	1	0	29068	10884	18184	0	0	0	6
21-27118320-C-CTTT	0.000137608	9.1878E-05	0.00016498	4	1	3	29068	10884	18184	0	0	0	4
21-27118320-C-CTTTTT	0.000137608	0.000275634	5.49934E-05	4	3	1	29068	10884	18184	0	0	0	496
21-27118320-CT-C	0.235138296	0.368706358	0.155191377	6835	4013	2822	29068	10884	18184	888	728	160	370
21-27118320-CTT-C	0.002545755	0.001561926	0.003134624	74	17	57	29068	10884	18184	0	0	0	147
21-27118352-T-C	3.19244E-05	0	5.01605E-05	1	0	1	31324	11388	19936	0	0	0	2
21-27118353-C-T	6.48803E-05	0.000176616	0	2	2	0	30826	11324	19502	0	0	0	257
21-27118391-C-T	0.000160318	0.000176305	0.000151179	5	2	3	31188	11344	19844	0	0	0	310
21-27118392-G-T	0.002049968	0.005632811	0	64	64	0	31220	11362	19858	0	0	0	333
21-27118413-C-T	3.1902E-05	0	5.01102E-05	1	0	1	31346	11390	19956	0	0	0	334
21-27118425-C-T	0.000255314	0.000351309	0.000200521	8	4	4	31334	11386	19948	0	0	0	68
21-27118448-G-A	9.58405E-05	0	0.000150602	3	0	3	31302	11382	19920	0	0	0	93
21-27118450-G-A	6.3804E-05	0.000175469	0	2	2	0	31346	11398	19948	0	0	0	35
21-27118471-C-T	3.19366E-05	8.7858E-05	0	1	1	0	31312	11382	19930	0	0	0	193
21-27118472-G-A	3.19428E-05	8.77963E-05	0	1	1	0	31306	11390	19916	0	0	0	471
21-27118479-C-T	3.19061E-05	0	5.01303E-05	1	0	1	31342	11394	19948	0	0	0	190
21-27118498-G-A	0.000159939	8.79972E-05	0.000201025	5	1	4	31262	11364	19898	0	0	0	72
21-27118500-A-G	6.3955E-05	8.80127E-05	5.0226E-05	2	1	1	31272	11362	19910	0	0	0	300
21-27118514-C-T	0.000255575	0.000615872	5.01605E-05	8	7	1	31302	11366	19936	0	0	0	167
21-27118520-T-C	3.19183E-05	0	5.00902E-05	1	0	1	31330	11366	19964	0	0	0	227
21-27118531-G-T	3.1904E-05	0	5.01303E-05	1	0	1	31344	11396	19948	0	0	0	153
21-27118538-C-T	3.18756E-05	0	5.00701E-05	1	0	1	31372	11400	19972	0	0	0	98
21-27118568-C-T	3.18695E-05	0	5.004E-05	1	0	1	31378	11394	19984	0	0	0	342
21-27118575-C-T	0.000477829	0.000350631	0.00055044	15	4	11	31392	11408	19984	0	0	0	209
21-27118628-GTT-G	3.18898E-05	8.76885E-05	0	1	1	0	31358	11404	19954	0	0	0	479
21-27118650-A-T	0.000223442	0.000527148	5.01354E-05	7	6	1	31328	11382	19946	0	0	0	95
21-27118656-A-AT	6.37389E-05	0.000175377	0	2	2	0	31378	11404	19974	0	0	0	210
21-27118685-C-A	3.18817E-05	0	5.00851E-05	1	0	1	31366	11400	19966	0	0	0	54
21-27118686-G-A	3.18939E-05	0	5.01153E-05	1	0	1	31354	11400	19954	0	0	0	373
21-27118733-A-G	0.001051223	0.000175254	0.001551552	33	2	31	31392	11412	19980	1	0	1	216
21-27118748-A-G	6.37349E-05	0.000175223	0	2	2	0	31380	11414	19966	0	0	0	121
21-27118753-A-G	3.18492E-05	0	5.0045E-05	1	0	1	31398	11416	19982	0	0	0	421
21-27118761-T-A	3.18451E-05	8.75964E-05	0	1	1	0	31402	11416	19986	0	0	0	465
21-27118782-C-T	3.18918E-05	8.76117E-05	0	1	1	0	31356	11414	19942	0	0	0	217
21-27118816-A-G	9.55718E-05	0.000175285	5.00501E-05	3	2	1	31390	11410	19980	0	0	0	404
21-27118816-ATAT-A	3.18573E-05	8.76424E-05	0	1	1	0	31390	11410	19980	0	0	0	258
21-27118826-A-G	3.18593E-05	0	5.00701E-05	1	0	1	31388	11416	19972	0	0	0	115
21-27118840-T-C	0.004968469	0.013494567	0.00010007	156	154	2	31398	11412	19986	2	2	0	159
21-27118846-A-C	0.01319564	0.036134012	0.00010014	414	412	2	31374	11402	19972	10	10	0	320
21-27118882-A-C	3.18613E-05	0	5.00551E-05	1	0	1	31386	11408	19978	0	0	0	140
21-27118886-T-C	0.000159256	0	0.000250175	5	0	5	31396	11410	19986	0	0	0	221
21-27118891-T-G	3.18532E-05	0	5.004E-05	1	0	1	31394	11410	19984	0	0	0	415
21-27118964-GGGAA-G	0.030861838	0.013499299	0.040770385	969	154	815	31398	11408	19990	17	4	13	331
21-27118966-G-T	3.18431E-05	0	5.002E-05	1	0	1	31404	11412	19992	0	0	0	471
21-27118968-A-ATTTTT	6.37146E-05	0.000175316	0	2	2	0	31390	11408	19982	0	0	0	139
21-27118968-A-G	0.030869704	0.013499299	0.040786708	969	154	815	31390	11408	19982	17	4	13	127
21-27118980-G-A	0.000160143	0.000439213	0	5	5	0	31222	11384	19838	0	0	0	202
21-27118992-A-G	3.1841E-05	0	5.0025E-05	1	0	1	31406	11416	19990	0	0	0	213
21-27119004-T-G	3.18512E-05	0	5.0045E-05	1	0	1	31396	11414	19982	0	0	0	33
21-27119010-C-T	0.000127836	0.000351185	0	4	4	0	31290	11390	19900	0	0	0	220
21-27119025-G-C	0.000923567	0.002541185	0	29	29	0	31400	11412	19988	0	0	0	336
21-27119063-A-G	0.00012738	0.000350508	0	4	4	0	31402	11412	19990	0	0	0	468
21-27119064-T-C	3.18451E-05	0	5.002E-05	1	0	1	31402	11410	19992	0	0	0	231
21-27119067-A-T	3.18492E-05	0	5.0025E-05	1	0	1	31398	11408	19990	0	0	0	473
21-27119116-A-G	3.1839E-05	8.76271E-05	0	1	1	0	31408	11412	19996	0	0	0	106
21-27119120-A-T	3.1839E-05	8.76271E-05	0	1	1	0	31408	11412	19996	0	0	0	155
21-27119132-A-G	3.18471E-05	0	5.0015E-05	1	0	1	31400	11406	19994	0	0	0	426
21-27119137-C-T	3.18471E-05	8.76578E-05	0	1	1	0	31400	11408	19992	0	0	0	20
21-27119142-G-A	3.18634E-05	8.76732E-05	0	1	1	0	31384	11406	19978	0	0	0	494
21-27119146-A-G	0.000191058	0	0.00030012	6	0	6	31404	11412	19992	0	0	0	212
21-27119162-A-G	3.18431E-05	8.76117E-05	0	1	1	0	31404	11414	19990	0	0	0	100
21-27119166-A-G	0.083232465	0.108627038	0.068741245	2613	1239	1374	31394	11406	19988	106	65	41	13
21-27119204-A-G	3.1839E-05	8.76117E-05	0	1	1	0	31408	11414	19994	0	0	0	222
21-27119224-GATAGA-G	6.37105E-05	0.000175285	0	2	2	0	31392	11410	19982	0	0	0	407
21-27119232-A-G	3.1835E-05	0	5.0005E-05	1	0	1	31412	11414	19998	0	0	0	311
21-27119239-G-T	6.37064E-05	0.000175377	0	2	2	0	31394	11404	19990	0	0	0	33
21-27119260-T-C	3.1837E-05	0	5.0005E-05	1	0	1	31410	11412	19998	0	0	0	475
21-27119272-A-G	3.1839E-05	0	5.0005E-05	1	0	1	31408	11410	19998	0	0	0	332
21-27119280-A-G	3.1837E-05	8.75964E-05	0	1	1	0	31410	11416	19994	0	0	0	173
21-27119284-T-A	3.18471E-05	0	5.003E-05	1	0	1	31400	11412	19988	0	0	0	387
21-27119286-C-T	0.000127681	8.77655E-05	0.000150497	4	1	3	31328	11394	19934	0	0	0	412
21-27119303-A-G	0.000541298	0.001489921	0	17	17	0	31406	11410	19996	0	0	0	162
21-27119307-A-G	3.18431E-05	0	5.002E-05	1	0	1	31404	11412	19992	0	0	0	361
21-27119314-ACT-A	0.000605636	0.000789612	0.000500651	19	9	10	31372	11398	19974	0	0	0	275
21-27119315-C-G	3.18492E-05	0	5.0025E-05	1	0	1	31398	11408	19990	0	0	0	435
21-27119317-C-CT	0.000191351	0.000175654	0.0002003	6	2	4	31356	11386	19970	0	0	0	76
21-27119322-T-C	3.18471E-05	0	5.0015E-05	1	0	1	31400	11406	19994	0	0	0	40
21-27119329-C-T	6.36943E-05	0	0.00010002	2	0	2	31400	11404	19996	0	0	0	499
21-27119334-T-C	9.55292E-05	0.000262973	0	3	3	0	31404	11408	19996	0	0	0	114
21-27119346-T-G	3.18451E-05	0	5.0005E-05	1	0	1	31402	11404	19998	0	0	0	206
21-27119347-C-G	9.55475E-05	8.77039E-05	0.00010002	3	1	2	31398	11402	19996	0	0	0	368
21-27119358-G-A	3.18451E-05	8.76578E-05	0	1	1	0	31402	11408	19994	0	0	0	425
21-27119362-A-G	0.000159205	0.000350693	0.00005	5	4	1	31406	11406	20000	0	0	0	470
21-27119373-C-T	3.1837E-05	0	5.0005E-05	1	0	1	31410	11412	19998	0	0	0	369
21-27119379-G-A	3.1835E-05	8.76271E-05	0	1	1	0	31412	11412	20000	0	0	0	94
21-27119383-A-G	3.1841E-05	8.76578E-05	0	1	1	0	31406	11408	19998	0	0	0	72
21-27119405-G-T	0.033356697	0.090582252	0.00070056	1047	1033	14	31388	11404	19984	56	56	0	424
21-27119420-C-T	6.3743E-05	0.000175439	0	2	2	0	31376	11400	19976	0	0	0	145
21-27119429-G-C	9.55231E-05	0.000262881	0	3	3	0	31406	11412	19994	0	0	0	476
21-27119463-C-T	3.18492E-05	8.76271E-05	0	1	1	0	31398	11412	19986	0	0	0	174
21-27119466-CTG-C	6.36821E-05	0.000175254	0	2	2	0	31406	11412	19994	0	0	0	324
21-27119474-C-T	3.18532E-05	0	5.0045E-05	1	0	1	31394	11412	19982	0	0	0	238
21-27119479-A-G	3.18532E-05	8.76578E-05	0	1	1	0	31394	11408	19986	0	0	0	227
21-27119479-A-T	6.37064E-05	0.000175316	0	2	2	0	31394	11408	19986	0	0	0	144
21-27119484-C-T	3.18532E-05	8.76578E-05	0	1	1	0	31394	11408	19986	0	0	0	292
21-27119494-T-G	3.18512E-05	0	5.0045E-05	1	0	1	31396	11414	19982	0	0	0	220
21-27119500-C-T	3.22956E-05	0	5.09321E-05	1	0	1	30964	11330	19634	0	0	0	345
21-27119503-A-T	3.1841E-05	0	5.0025E-05	1	0	1	31406	11416	19990	0	0	0	29
21-27119563-C-T	3.18492E-05	0	5.003E-05	1	0	1	31398	11410	19988	0	0	0	16
21-27119590-G-A	3.18451E-05	8.76117E-05	0	1	1	0	31402	11414	19988	0	0	0	202
21-27119635-T-G	3.1841E-05	0	5.0005E-05	1	0	1	31406	11408	19998	0	0	0	400
21-27119645-C-T	0.033367327	0.090582252	0.000700911	1047	1033	14	31378	11404	19974	56	56	0	188
21-27119647-T-G	6.36821E-05	0.000175254	0	2	2	0	31406	11412	19994	0	0	0	412
21-27119672-G-A	3.18613E-05	8.76885E-05	0	1	1	0	31386	11404	19982	0	0	0	26
21-27119681-G-A	0.000127429	0.000350754	0	4	4	0	31390	11404	19986	0	0	0	413
21-27119681-G-C	6.37146E-05	0.000175377	0	2	2	0	31390	11404	19986	0	0	0	457
21-27119688-G-A	3.18471E-05	8.76578E-05	0	1	1	0	31400	11408	19992	0	0	0	74
21-27119693-C-T	6.36983E-05	0	0.00010006	2	0	2	31398	11410	19988	0	0	0	120
21-27119703-T-A	3.18471E-05	8.76578E-05	0	1	1	0	31400	11408	19992	0	0	0	418
21-27119704-C-A	3.18512E-05	8.76424E-05	0	1	1	0	31396	11410	19986	0	0	0	472
21-27119706-A-C	3.18573E-05	0	5.003E-05	1	0	1	31390	11402	19988	0	0	0	343
21-27119722-A-G	3.18451E-05	8.76117E-05	0	1	1	0	31402	11414	19988	0	0	0	319
21-27119723-T-G	9.55414E-05	0.000262973	0	3	3	0	31400	11408	19992	0	0	0	173
21-27119761-A-G	0.009838258	0.026906223	0.00010001	309	307	2	31408	11410	19998	6	6	0	469
21-27119776-A-C	0.000318309	0.000875964	0	10	10	0	31416	11416	20000	0	0	0	392
21-27119815-C-A	6.36699E-05	0.000175223	0	2	2	0	31412	11414	19998	0	0	0	495
21-27119815-C-G	3.1835E-05	0	5.0005E-05	1	0	1	31412	11414	19998	0	0	0	394
21-27119837-A-G	3.18329E-05	8.75964E-05	0	1	1	0	31414	11416	19998	0	0	0	346
21-27119865-G-A	9.55292E-05	0.000263066	0	3	3	0	31404	11404	20000	0	0	0	324
21-27119868-A-G	3.1839E-05	0	5.0005E-05	1	0	1	31408	11410	19998	0	0	0	128
21-27119869-A-G	0.000286515	0.000613282	0.00010001	9	7	2	31412	11414	19998	0	0	0	303
21-27119869-A-T	3.1835E-05	0	5.0005E-05	1	0	1	31412	11414	19998	0	0	0	492
21-27119885-C-T	6.36862E-05	8.76424E-05	5.0015E-05	2	1	1	31404	11410	19994	0	0	0	122
21-27119887-G-T	6.36821E-05	0.000175285	0	2	2	0	31406	11410	19996	0	0	0	350
21-27119912-A-G	9.55657E-05	0.000263066	0	3	3	0	31392	11404	19988	0	0	0	492
21-27119914-G-A	3.1841E-05	0	5.001E-05	1	0	1	31406	11410	19996	0	0	0	46
21-27119946-C-T	3.18471E-05	8.76271E-05	0	1	1	0	31400	11412	19988	0	0	0	443
21-27119947-A-G	0.993310398	0.981669882	0.999949975	31182	11193	19989	31392	11402	19990	15487	5493	9994	162
21-27119962-T-C	3.18552E-05	8.76732E-05	0	1	1	0	31392	11406	19986	0	0	0	288
21-27119989-A-G	0.006721458	0.018148343	0.00020014	211	207	4	31392	11406	19986	3	3	0	272
21-27119989-AT-A	3.18552E-05	8.76732E-05	0	1	1	0	31392	11406	19986	0	0	0	294
21-27119996-G-T	3.18573E-05	0	5.0045E-05	1	0	1	31390	11408	19982	0	0	0	320
21-27120032-T-C	3.18451E-05	0	5.001E-05	1	0	1	31402	11406	19996	0	0	0	380
21-27120050-C-A	0.000159317	0.000438904	0	5	5	0	31384	11392	19992	0	0	0	104
21-27120059-T-G	3.18532E-05	8.77347E-05	0	1	1	0	31394	11398	19996	0	0	0	389
21-27120072-G-A	3.1839E-05	8.76424E-05	0	1	1	0	31408	11410	19998	0	0	0	258
21-27120087-G-T	6.36821E-05	0.000175346	0	2	2	0	31406	11406	20000	0	0	0	127
21-27120098-A-G	3.1841E-05	8.76732E-05	0	1	1	0	31406	11406	20000	0	0	0	189
21-27120105-C-T	6.36983E-05	0.000175316	0	2	2	0	31398	11408	19990	0	0	0	144
21-27120112-C-T	6.37186E-05	0.000175316	0	2	2	0	31388	11408	19980	0	0	0	444
21-27120116-A-C	3.1837E-05	0	5.001E-05	1	0	1	31410	11414	19996	0	0	0	123
21-27120116-A-G	0.000445718	0.001226564	0	14	14	0	31410	11414	19996	0	0	0	92
21-27120121-A-T	0.006721029	0.01815471	0.00020008	211	207	4	31394	11402	19992	3	3	0	57
21-27120191-AATCT-A	6.36862E-05	8.76885E-05	0.00005	2	1	1	31404	11404	20000	0	0	0	246
21-27120200-G-A	0.000159368	8.77501E-05	0.00020022	5	1	4	31374	11396	19978	0	0	0	174
21-27120205-CA-C	3.18837E-05	0	5.00701E-05	1	0	1	31364	11392	19972	0	0	0	346
21-27120214-A-C	3.18959E-05	8.78735E-05	0	1	1	0	31352	11380	19972	0	0	0	484
21-27120217-G-GT	0.003661827	0.010068892	0	114	114	0	31132	11322	19810	0	0	0	27
21-27120222-T-G	9.56084E-05	0.00026325	0	3	3	0	31378	11396	19982	0	0	0	185
21-27120222-TTTTTG-T	0.007776149	0.021147771	0.000150135	244	241	3	31378	11396	19982	3	3	0	51
21-27120256-C-A	3.19407E-05	8.77655E-05	0	1	1	0	31308	11394	19914	0	0	0	158
21-27120287-C-T	3.19081E-05	0	5.01354E-05	1	0	1	31340	11394	19946	0	0	0	90
21-27120299-C-T	0.04010081	0.108516242	0.001052315	1257	1236	21	31346	11390	19956	85	85	0	153
21-27120300-G-A	9.57121E-05	8.76885E-05	0.000100301	3	1	2	31344	11404	19940	0	0	0	353
21-27120313-G-A	6.37592E-05	0	0.00010018	2	0	2	31368	11404	19964	0	0	0	443
21-27120330-G-A	9.56023E-05	0.000262973	0	3	3	0	31380	11408	19972	0	0	0	56
21-27120332-C-T	6.3743E-05	0.000175316	0	2	2	0	31376	11408	19968	0	0	0	235
21-27120344-A-G	3.18817E-05	0	5.00801E-05	1	0	1	31366	11398	19968	0	0	0	329
21-27120359-AG-A	6.37227E-05	0	0.00010008	2	0	2	31386	11402	19984	0	0	0	457
21-27120366-C-T	3.18756E-05	0	5.00801E-05	1	0	1	31372	11404	19968	0	0	0	60
21-27120367-G-A	3.18756E-05	8.77193E-05	0	1	1	0	31372	11400	19972	0	0	0	251
21-27120379-A-G	0.023630334	0.064465133	0.000350491	741	734	7	31358	11386	19972	30	30	0	191
21-27120394-T-C	0.120866845	0.146701847	0.106151688	3787	1668	2119	31332	11370	19962	240	142	98	385
21-27120400-A-G	3.18837E-05	8.77039E-05	0	1	1	0	31364	11402	19962	0	0	0	312
21-27120409-G-T	3.18715E-05	0	5.00751E-05	1	0	1	31376	11406	19970	0	0	0	233
21-27120429-C-T	3.18674E-05	0	5.00551E-05	1	0	1	31380	11402	19978	0	0	0	137
21-27120436-C-T	0.00041425	0.000876578	0.000150195	13	10	3	31382	11408	19974	0	0	0	175
21-27120437-G-A	3.18634E-05	8.76885E-05	0	1	1	0	31384	11404	19980	0	0	0	50
21-27120439-AC-A	6.37511E-05	0	0.00010017	2	0	2	31372	11406	19966	0	0	0	355
21-27120487-G-T	3.18695E-05	8.76732E-05	0	1	1	0	31378	11406	19972	0	0	0	352
21-27120501-G-C	0.000191144	0.00052567	0	6	6	0	31390	11414	19976	0	0	0	451
21-27120516-C-T	0.000127405	0.000262973	5.003E-05	4	3	1	31396	11408	19988	0	0	0	416
21-27120572-G-A	3.1837E-05	0	5.001E-05	1	0	1	31410	11414	19996	0	0	0	442
21-27120579-C-T	3.18492E-05	8.76578E-05	0	1	1	0	31398	11408	19990	0	0	0	389
21-27120585-C-G	0.000732624	0	0.001150575	23	0	23	31394	11404	19990	0	0	0	49
21-27120586-G-A	0.009172559	0.025065732	0.00010006	288	286	2	31398	11410	19988	4	4	0	301
21-27120596-G-T	9.55353E-05	0	0.00015003	3	0	3	31402	11406	19996	0	0	0	79
21-27120614-C-T	0.009712757	0.026560309	0.00010003	305	303	2	31402	11408	19994	5	5	0	281
21-27120615-G-A	3.18756E-05	0	5.00651E-05	1	0	1	31372	11398	19974	0	0	0	459
21-27120615-G-C	0.092024735	0.133093525	0.068589166	2887	1517	1370	31372	11398	19974	152	112	40	419
21-27120616-A-T	0.091995411	0.133023501	0.068575433	2887	1517	1370	31382	11404	19978	152	112	40	257
21-27120674-T-C	3.18431E-05	8.76424E-05	0	1	1	0	31404	11410	19994	0	0	0	215
21-27120689-T-G	0.003438833	0.009465381	0	108	108	0	31406	11410	19996	2	2	0	291
21-27120695-C-T	3.18512E-05	0	5.0025E-05	1	0	1	31396	11406	19990	0	0	0	77
21-27120698-A-T	3.1839E-05	0	5.002E-05	1	0	1	31408	11416	19992	0	0	0	416
21-27120704-G-A	3.1841E-05	8.76271E-05	0	1	1	0	31406	11412	19994	0	0	0	28
21-27120734-TATC-T	0.000700503	0.001928133	0	22	22	0	31406	11410	19996	0	0	0	165
21-27120749-A-G	3.1841E-05	8.76424E-05	0	1	1	0	31406	11410	19996	0	0	0	44
21-27120755-T-G	0.000222887	0.000613497	0	7	7	0	31406	11410	19996	0	0	0	441
21-27120759-A-G	3.18492E-05	0	5.0015E-05	1	0	1	31398	11404	19994	0	0	0	1
21-27120781-A-G	0.000127413	0.000350877	0	4	4	0	31394	11400	19994	0	0	0	13
21-27120784-G-GA	3.22497E-05	8.82145E-05	0	1	1	0	31008	11336	19672	0	0	0	227
21-27120790-AC-A	3.18492E-05	8.76732E-05	0	1	1	0	31398	11406	19992	0	0	0	180
21-27120792-ACT-A	3.18451E-05	8.76885E-05	0	1	1	0	31402	11404	19998	0	0	0	61
21-27120823-C-G	3.18573E-05	8.76732E-05	0	1	1	0	31390	11406	19984	0	0	0	468
21-27120852-A-G	3.1841E-05	0	5.001E-05	1	0	1	31406	11410	19996	0	0	0	275
21-27120891-A-G	3.18492E-05	8.77039E-05	0	1	1	0	31398	11402	19996	0	0	0	41
21-27120893-A-G	9.55414E-05	0.000262973	0	3	3	0	31400	11408	19992	0	0	0	274
21-27120896-T-G	3.1837E-05	8.76424E-05	0	1	1	0	31410	11410	20000	0	0	0	473
21-27120900-GTAAACCCTTATCTT-G	0.000477859	0.001314867	0	15	15	0	31390	11408	19982	0	0	0	487
21-27120922-T-G	0.000636862	0.001752541	0	20	20	0	31404	11412	19992	0	0	0	213
21-27120948-CAAG-C	3.18634E-05	8.77193E-05	0	1	1	0	31384	11400	19984	0	0	0	286
21-27120977-TATC-T	3.18613E-05	8.76424E-05	0	1	1	0	31386	11410	19976	0	0	0	431
21-27120979-T-C	3.18532E-05	8.76271E-05	0	1	1	0	31394	11412	19982	0	0	0	314
21-27120994-C-T	3.18715E-05	8.77347E-05	0	1	1	0	31376	11398	19978	0	0	0	162
21-27121000-T-C	3.18492E-05	8.76424E-05	0	1	1	0	31398	11410	19988	0	0	0	145
21-27121003-T-C	3.18492E-05	0	5.003E-05	1	0	1	31398	11410	19988	0	0	0	308
21-27121013-CAG-C	3.18512E-05	0	5.00501E-05	1	0	1	31396	11416	19980	0	0	0	292
21-27121015-G-A	9.55718E-05	0	0.000150135	3	0	3	31390	11408	19982	0	0	0	155
21-27121018-A-G	0.000191107	0	0.00030021	6	0	6	31396	11410	19986	0	0	0	181
21-27121021-G-A	3.18654E-05	8.76578E-05	0	1	1	0	31382	11408	19974	0	0	0	459
21-27121031-C-T	6.36983E-05	0.000175254	0	2	2	0	31398	11412	19986	0	0	0	466
21-27121056-A-G	3.18512E-05	8.76578E-05	0	1	1	0	31396	11408	19988	0	0	0	38
21-27121066-T-A	3.18492E-05	0	5.003E-05	1	0	1	31398	11410	19988	0	0	0	59
21-27121135-A-G	3.1839E-05	0	5.0015E-05	1	0	1	31408	11414	19994	0	0	0	188
21-27121140-G-C	3.18451E-05	8.76424E-05	0	1	1	0	31402	11410	19992	0	0	0	497
21-27121150-A-G	3.1839E-05	0	5.0015E-05	1	0	1	31408	11414	19994	0	0	0	331
21-27121188-G-C	3.18512E-05	0	5.0045E-05	1	0	1	31396	11414	19982	0	0	0	428
21-27121197-A-G	0.000636821	0.001577287	0.00010003	20	18	2	31406	11412	19994	0	0	0	268
21-27121204-G-A	3.18492E-05	0	5.002E-05	1	0	1	31398	11406	19992	0	0	0	432
21-27121217-T-C	3.1839E-05	0	5.001E-05	1	0	1	31408	11412	19996	0	0	0	36
21-27121219-C-T	3.18593E-05	8.77039E-05	0	1	1	0	31388	11402	19986	0	0	0	261
21-27121222-A-G	3.1837E-05	0	5.001E-05	1	0	1	31410	11414	19996	0	0	0	132
21-27121225-A-C	3.18512E-05	0	5.0025E-05	1	0	1	31396	11406	19990	0	0	0	452
21-27121261-G-T	3.18573E-05	0	5.0035E-05	1	0	1	31390	11404	19986	0	0	0	224
21-27121265-A-C	3.18512E-05	0	5.0025E-05	1	0	1	31396	11406	19990	0	0	0	15
21-27121282-C-G	9.55962E-05	8.77039E-05	0.0001001	3	1	2	31382	11402	19980	0	0	0	477
21-27121299-A-G	3.18512E-05	8.76424E-05	0	1	1	0	31396	11410	19986	0	0	0	280
21-27121338-C-T	0.000382214	0.000175223	0.00050045	12	2	10	31396	11414	19982	0	0	0	81
21-27121355-A-C	3.1837E-05	0	5.0015E-05	1	0	1	31410	11416	19994	0	0	0	108
21-27121367-A-G	3.18532E-05	0	5.0035E-05	1	0	1	31394	11408	19986	0	0	0	322
21-27121388-A-G	0.016178344	0.005171809	0.022458984	508	59	449	31400	11408	19992	11	0	11	194
21-27121426-A-T	6.36983E-05	0.000175285	0	2	2	0	31398	11410	19988	0	0	0	337
21-27121446-A-G	9.55475E-05	0	0.000150075	3	0	3	31398	11408	19990	0	0	0	325
21-27121460-A-C	0.009682762	0.026472651	0.00010006	304	302	2	31396	11408	19988	5	5	0	332
21-27121483-A-T	3.18634E-05	8.77039E-05	0	1	1	0	31384	11402	19982	0	0	0	343
21-27121486-C-G	3.18552E-05	8.76578E-05	0	1	1	0	31392	11408	19984	0	0	0	347
21-27121487-A-G	0.000796331	0.000350693	0.00105063	25	4	21	31394	11406	19988	0	0	0	323
21-27121492-A-G	6.36862E-05	0.000175285	0	2	2	0	31404	11410	19994	0	0	0	415
21-27121509-T-A	3.18431E-05	0	5.002E-05	1	0	1	31404	11412	19992	0	0	0	393
21-27121511-C-T	0.000222973	8.76424E-05	0.00030024	7	1	6	31394	11410	19984	0	0	0	157
21-27121525-A-G	3.18431E-05	8.76271E-05	0	1	1	0	31404	11412	19992	0	0	0	152
21-27121586-G-A	3.18451E-05	8.76424E-05	0	1	1	0	31402	11410	19992	0	0	0	92
21-27121608-C-T	0.000127389	0.000350693	0	4	4	0	31400	11406	19994	0	0	0	392
21-27121615-C-G	3.18512E-05	0	5.003E-05	1	0	1	31396	11408	19988	0	0	0	186
21-27121628-T-C	3.18573E-05	8.76885E-05	0	1	1	0	31390	11404	19986	0	0	0	423
21-27121628-TA-T	3.18573E-05	0	5.0035E-05	1	0	1	31390	11404	19986	0	0	0	480
21-27121635-A-T	3.18471E-05	8.76578E-05	0	1	1	0	31400	11408	19992	0	0	0	237
21-27121681-G-C	3.18613E-05	8.76732E-05	0	1	1	0	31386	11406	19980	0	0	0	24
21-27121694-A-C	6.37349E-05	0.000175316	0	2	2	0	31380	11408	19972	0	0	0	284
21-27121723-A-G	3.18573E-05	0	5.0035E-05	1	0	1	31390	11404	19986	0	0	0	463
21-27121727-C-A	3.18532E-05	0	5.003E-05	1	0	1	31394	11406	19988	0	0	0	443
21-27121736-A-C	3.18654E-05	0	5.00601E-05	1	0	1	31382	11406	19976	0	0	0	338
21-27121736-A-G	3.18654E-05	8.76732E-05	0	1	1	0	31382	11406	19976	0	0	0	477
21-27121737-C-A	3.18552E-05	8.76732E-05	0	1	1	0	31392	11406	19986	0	0	0	56
21-27121754-G-T	3.18613E-05	8.76885E-05	0	1	1	0	31386	11404	19982	0	0	0	195
21-27121762-A-G	0.0922822	0.133292383	0.068898229	2896	1519	1377	31382	11396	19986	155	112	43	137
21-27121767-C-T	3.18552E-05	8.76732E-05	0	1	1	0	31392	11406	19986	0	0	0	38
21-27121782-C-T	3.18552E-05	0	5.0035E-05	1	0	1	31392	11406	19986	0	0	0	445
21-27121792-A-G	0.121165742	0.147389699	0.106234988	3800	1677	2123	31362	11378	19984	247	149	98	86
21-27121815-C-T	3.18715E-05	0	5.00601E-05	1	0	1	31376	11400	19976	0	0	0	150
21-27121829-A-C	3.18674E-05	0	5.00601E-05	1	0	1	31380	11404	19976	0	0	0	329
21-27121832-G-A	0.000573394	0.001577564	0	18	18	0	31392	11410	19982	0	0	0	99
21-27121864-T-C	3.18451E-05	8.76117E-05	0	1	1	0	31402	11414	19988	0	0	0	383
21-27121877-T-TCAC	3.18492E-05	0	5.003E-05	1	0	1	31398	11410	19988	0	0	0	381
21-27121880-C-T	9.55536E-05	0	0.00015009	3	0	3	31396	11408	19988	0	0	0	108
21-27121881-G-A	0.00722976	0.001051525	0.01075753	227	12	215	31398	11412	19986	0	0	0	118
21-27121882-C-T	3.18451E-05	8.76271E-05	0	1	1	0	31402	11412	19990	0	0	0	210
21-27121883-C-T	0.01977833	0.053646564	0.000450225	621	612	9	31398	11408	19990	19	19	0	102
21-27121907-C-T	3.18471E-05	8.76271E-05	0	1	1	0	31400	11412	19988	0	0	0	195
21-27121915-G-C	3.18471E-05	0	5.0035E-05	1	0	1	31400	11414	19986	0	0	0	350
21-27121921-T-A	3.18492E-05	0	5.003E-05	1	0	1	31398	11410	19988	0	0	0	228
21-27121923-A-G	6.37024E-05	8.76424E-05	5.0035E-05	2	1	1	31396	11410	19986	0	0	0	496
21-27121936-A-C	0.000350296	0.000876424	5.002E-05	11	10	1	31402	11410	19992	0	0	0	233
21-27121937-G-A	3.18492E-05	0	5.0035E-05	1	0	1	31398	11412	19986	0	0	0	346
21-27121957-A-G	3.18431E-05	8.76578E-05	0	1	1	0	31404	11408	19996	0	0	0	63
21-27121962-G-C	3.18431E-05	0	5.002E-05	1	0	1	31404	11412	19992	0	0	0	270
21-27121972-A-G	3.18654E-05	0	5.00551E-05	1	0	1	31382	11404	19978	0	0	0	169
21-27121980-T-A	3.18593E-05	8.76578E-05	0	1	1	0	31388	11408	19980	0	0	0	271
21-27121981-A-G	3.18492E-05	8.76732E-05	0	1	1	0	31398	11406	19992	0	0	0	67
21-27122060-T-C	6.36862E-05	0.000175254	0	2	2	0	31404	11412	19992	0	0	0	431
21-27122064-C-T	3.1841E-05	8.75964E-05	0	1	1	0	31406	11416	19990	0	0	0	185
21-27122107-A-C	3.18451E-05	0	0.00005	1	0	1	31402	11402	20000	0	0	0	437
21-27122126-G-A	6.37024E-05	0.000175285	0	2	2	0	31396	11410	19986	0	0	0	72
21-27122135-T-A	3.18593E-05	8.77347E-05	0	1	1	0	31388	11398	19990	0	0	0	456
21-27122136-C-G	3.18573E-05	8.76885E-05	0	1	1	0	31390	11404	19986	0	0	0	58
21-27122138-GTCT-G	9.56023E-05	0	0.000150165	3	0	3	31380	11402	19978	0	0	0	273
21-27122141-T-TGA	9.55353E-05	0	0.000150045	3	0	3	31402	11408	19994	0	0	0	153
21-27122144-ATCAG-A	6.36983E-05	0	0.00010004	2	0	2	31398	11406	19992	0	0	0	493
21-27122146-C-T	3.18451E-05	0	5.0015E-05	1	0	1	31402	11408	19994	0	0	0	120
21-27122147-A-G	6.3678E-05	0	0.00010002	2	0	2	31408	11412	19996	0	0	0	442
21-27122154-C-T	9.57488E-05	0	0.000150482	3	0	3	31332	11396	19936	0	0	0	404
21-27122157-T-TA	0.000255265	8.77193E-05	0.000351053	8	1	7	31340	11400	19940	0	0	0	410
21-27122158-A-T	9.56023E-05	0	0.000150195	3	0	3	31380	11406	19974	0	0	0	343
21-27122160-A-G	3.18532E-05	8.76732E-05	0	1	1	0	31394	11406	19988	0	0	0	352
21-27122167-G-C	3.18532E-05	8.76578E-05	0	1	1	0	31394	11408	19986	0	0	0	53
21-27122169-T-C	3.18532E-05	8.76885E-05	0	1	1	0	31394	11404	19990	0	0	0	302
21-27122193-A-G	9.55536E-05	0.000175254	5.004E-05	3	2	1	31396	11412	19984	0	0	0	137
21-27122194-C-T	0.014525994	0.03945292	0.00030021	456	450	6	31392	11406	19986	14	14	0	336
21-27122197-T-A	0.000764477	0	0.001200961	24	0	24	31394	11410	19984	0	0	0	464
21-27122210-G-C	3.19714E-05	0	5.02816E-05	1	0	1	31278	11390	19888	0	0	0	386
21-27122226-A-G	3.1839E-05	0	5.002E-05	1	0	1	31408	11416	19992	0	0	0	133
21-27122238-C-T	0.000159226	0.000350447	5.003E-05	5	4	1	31402	11414	19988	0	0	0	451
21-27122239-G-A	3.18451E-05	0	5.002E-05	1	0	1	31402	11410	19992	0	0	0	217
21-27122243-A-G	3.18492E-05	0	5.0045E-05	1	0	1	31398	11416	19982	0	0	0	189
21-27122250-C-T	3.18512E-05	0	5.0035E-05	1	0	1	31396	11410	19986	0	0	0	165
21-27122254-G-A	3.18431E-05	0	5.001E-05	1	0	1	31404	11408	19996	0	0	0	121
21-27122264-C-T	3.18431E-05	8.76117E-05	0	1	1	0	31404	11414	19990	0	0	0	358
21-27122278-G-A	6.36821E-05	0.000175193	0	2	2	0	31406	11416	19990	0	0	0	306
21-27122280-G-A	3.18431E-05	0	5.0025E-05	1	0	1	31404	11414	19990	0	0	0	460
21-27122287-G-A	3.18431E-05	8.76271E-05	0	1	1	0	31404	11412	19992	0	0	0	144
21-27122295-T-TATA	0.000127332	0	0.00020002	4	0	4	31414	11416	19998	0	0	0	85
21-27122304-A-G	3.18492E-05	8.76271E-05	0	1	1	0	31398	11412	19986	0	0	0	138
21-27122311-T-G	3.18451E-05	0	5.0025E-05	1	0	1	31402	11412	19990	0	0	0	266
21-27122321-A-G	0.321979844	0.113704159	0.440925944	10096	1296	8800	31356	11398	19958	2066	103	1963	358
21-27122336-C-T	3.18451E-05	0	5.002E-05	1	0	1	31402	11410	19992	0	0	0	409
21-27122348-G-A	3.18451E-05	0	5.002E-05	1	0	1	31402	11410	19992	0	0	0	100
21-27122353-A-T	3.1839E-05	8.76117E-05	0	1	1	0	31408	11414	19994	0	0	0	441
21-27122409-G-C	6.36821E-05	0.000175285	0	2	2	0	31406	11410	19996	0	0	0	287
21-27122423-A-G	3.1839E-05	0	5.001E-05	1	0	1	31408	11412	19996	0	0	0	253
21-27122430-G-C	3.1837E-05	0	5.001E-05	1	0	1	31410	11414	19996	0	0	0	445
21-27122444-A-G	3.18329E-05	8.75964E-05	0	1	1	0	31414	11416	19998	0	0	0	103
21-27122451-A-G	0.196657524	0.353163445	0.107489737	6166	4019	2147	31354	11380	19974	846	742	104	216
21-27122454-C-T	0.000350296	0.000876578	5.0015E-05	11	10	1	31402	11408	19994	0	0	0	144
21-27122455-G-A	6.36821E-05	8.76578E-05	5.0005E-05	2	1	1	31406	11408	19998	0	0	0	30
21-27122470-C-T	6.37024E-05	0.000175377	0	2	2	0	31396	11404	19992	0	0	0	281
21-27122484-A-G	3.1839E-05	0	5.0015E-05	1	0	1	31408	11414	19994	0	0	0	315
21-27122486-A-G	3.1837E-05	8.76117E-05	0	1	1	0	31410	11414	19996	0	0	0	387
21-27122499-C-G	3.18471E-05	8.76578E-05	0	1	1	0	31400	11408	19992	0	0	0	81
21-27122515-A-G	3.18532E-05	8.77039E-05	0	1	1	0	31394	11402	19992	0	0	0	248
21-27122534-A-G	3.18593E-05	0	5.004E-05	1	0	1	31388	11404	19984	0	0	0	471
21-27122545-C-T	3.18492E-05	0	5.0025E-05	1	0	1	31398	11408	19990	0	0	0	218
21-27122556-A-T	3.18471E-05	0	5.002E-05	1	0	1	31400	11408	19992	0	0	0	432
21-27122573-C-T	6.37186E-05	8.77193E-05	5.003E-05	2	1	1	31388	11400	19988	0	0	0	272
21-27122574-G-T	3.18532E-05	0	5.0035E-05	1	0	1	31394	11408	19986	0	0	0	102
21-27122584-A-G	6.3678E-05	0.000175285	0	2	2	0	31408	11410	19998	0	0	0	439
21-27122586-A-G	0.004649089	0.012710379	5.001E-05	146	145	1	31404	11408	19996	2	2	0	287
21-27122587-G-A	3.1841E-05	0	5.001E-05	1	0	1	31406	11410	19996	0	0	0	47
21-27122597-T-C	3.18451E-05	8.76578E-05	0	1	1	0	31402	11408	19994	0	0	0	129
21-27122600-C-T	3.18552E-05	8.76732E-05	0	1	1	0	31392	11406	19986	0	0	0	223
21-27122645-G-A	6.37105E-05	0	0.00010007	2	0	2	31392	11406	19986	0	0	0	278
21-27122655-C-T	0.000350385	0.000877039	5.002E-05	11	10	1	31394	11402	19992	0	0	0	298
21-27122660-G-A	3.18593E-05	0	5.003E-05	1	0	1	31388	11400	19988	0	0	0	189
21-27122666-C-T	3.18451E-05	0	5.001E-05	1	0	1	31402	11406	19996	0	0	0	80
21-27122670-C-A	3.1841E-05	8.76578E-05	0	1	1	0	31406	11408	19998	0	0	0	27
21-27122685-C-T	9.55597E-05	0.000263066	0	3	3	0	31394	11404	19990	0	0	0	167
21-27122696-A-G	3.18451E-05	8.76578E-05	0	1	1	0	31402	11408	19994	0	0	0	214
21-27122697-T-C	0.004713976	8.76732E-05	0.007353677	148	1	147	31396	11406	19990	0	0	0	101
21-27122717-T-C	9.55536E-05	0.000263066	0	3	3	0	31396	11404	19992	0	0	0	444
21-27122734-C-T	0.000191107	0.000175377	0.00020008	6	2	4	31396	11404	19992	0	0	0	472
21-27122735-G-A	6.37146E-05	8.77039E-05	5.003E-05	2	1	1	31390	11402	19988	0	0	0	364
21-27122760-T-C	3.18634E-05	8.77347E-05	0	1	1	0	31384	11398	19986	0	0	0	127
21-27122773-G-C	3.18431E-05	8.76424E-05	0	1	1	0	31404	11410	19994	0	0	0	477
21-27122786-AG-A	6.36821E-05	8.76424E-05	5.001E-05	2	1	1	31406	11410	19996	0	0	0	400
21-27122805-A-G	0.001050554	0.002891693	0	33	33	0	31412	11412	20000	0	0	0	291
21-27122831-A-G	0.000286515	0.000788505	0	9	9	0	31412	11414	19998	0	0	0	324
21-27122866-A-C	3.1839E-05	8.76117E-05	0	1	1	0	31408	11414	19994	0	0	0	298
21-27122867-G-A	3.18573E-05	0	5.0045E-05	1	0	1	31390	11408	19982	0	0	0	72
21-27122880-A-G	3.1839E-05	0	5.001E-05	1	0	1	31408	11412	19996	0	0	0	94
21-27122903-T-C	3.1841E-05	0	5.0015E-05	1	0	1	31406	11412	19994	0	0	0	361
21-27122909-T-G	6.37064E-05	0.000175346	0	2	2	0	31394	11406	19988	0	0	0	27
21-27122914-C-CT	0.000637349	0.000175377	0.000901081	20	2	18	31380	11404	19976	0	0	0	220
21-27122921-A-G	6.36943E-05	0.000175223	0	2	2	0	31400	11414	19986	0	0	0	241
21-27122930-A-G	3.1835E-05	8.76117E-05	0	1	1	0	31412	11414	19998	0	0	0	159
21-27122948-A-G	3.1837E-05	0	5.0015E-05	1	0	1	31410	11416	19994	0	0	0	84
21-27122951-T-C	3.1839E-05	8.75964E-05	0	1	1	0	31408	11416	19992	0	0	0	341
21-27122966-T-C	3.1837E-05	0	5.001E-05	1	0	1	31410	11414	19996	0	0	0	488
21-27122988-T-C	3.18431E-05	8.76117E-05	0	1	1	0	31404	11414	19990	0	0	0	396
21-27122990-C-T	6.36943E-05	0	0.00010007	2	0	2	31400	11414	19986	1	0	1	240
21-27123012-C-T	3.18552E-05	8.76117E-05	0	1	1	0	31392	11414	19978	0	0	0	403
21-27123024-C-T	6.37024E-05	0	0.00010006	2	0	2	31396	11408	19988	0	0	0	163
21-27123034-C-T	9.55536E-05	0	0.000150105	3	0	3	31396	11410	19986	0	0	0	227
21-27123050-G-A	9.55657E-05	0	0.000150105	3	0	3	31392	11406	19986	0	0	0	371
21-27123058-GAAA-G	0.000159246	0.000438135	0	5	5	0	31398	11412	19986	0	0	0	51
21-27123092-A-C	0.121167697	0.147816938	0.105948328	3802	1686	2116	31378	11406	19972	246	149	97	402
21-27123129-G-A	9.5645E-05	0.000175346	5.01002E-05	3	2	1	31366	11406	19960	0	0	0	80
21-27123139-A-G	0.000127405	0.00035057	0	4	4	0	31396	11410	19986	0	0	0	185
21-27123163-G-A	3.18613E-05	0	5.004E-05	1	0	1	31386	11402	19984	0	0	0	453
21-27123164-G-A	3.18532E-05	8.76578E-05	0	1	1	0	31394	11408	19986	0	0	0	294
21-27123173-A-G	3.18431E-05	8.76117E-05	0	1	1	0	31404	11414	19990	0	0	0	104
21-27123187-A-G	3.18451E-05	8.75964E-05	0	1	1	0	31402	11416	19986	0	0	0	171
21-27123214-A-G	3.18492E-05	0	5.003E-05	1	0	1	31398	11410	19988	0	0	0	154
21-27123229-A-G	0.011308614	0.029907034	0.00070035	355	341	14	31392	11402	19990	5	5	0	244
21-27123239-T-C	3.18512E-05	0	5.0025E-05	1	0	1	31396	11406	19990	0	0	0	175
21-27123249-AC-A	3.18593E-05	0	5.0045E-05	1	0	1	31388	11406	19982	0	0	0	474
21-27123251-C-A	3.18695E-05	0	5.00651E-05	1	0	1	31378	11404	19974	0	0	0	364
21-27123251-C-G	3.18695E-05	8.76885E-05	0	1	1	0	31378	11404	19974	0	0	0	7
21-27123263-G-A	3.18695E-05	8.76578E-05	0	1	1	0	31378	11408	19970	0	0	0	400
21-27123300-C-T	3.18979E-05	0	5.01253E-05	1	0	1	31350	11400	19950	0	0	0	163
21-27123301-G-A	0.000318878	0.000877193	0	10	10	0	31360	11400	19960	0	0	0	294
21-27123309-G-A	9.56328E-05	8.76885E-05	0.00010017	3	1	2	31370	11404	19966	0	0	0	357
21-27123309-G-C	3.18776E-05	8.76885E-05	0	1	1	0	31370	11404	19966	0	0	0	401
21-27123313-T-C	3.18674E-05	8.76578E-05	0	1	1	0	31380	11408	19972	0	0	0	90
21-27123321-C-A	9.56694E-05	8.76885E-05	0.000100231	3	1	2	31358	11404	19954	0	0	0	241
21-27123321-C-T	3.18898E-05	8.76885E-05	0	1	1	0	31358	11404	19954	0	0	0	379
21-27123328-C-A	3.19E-05	8.77347E-05	0	1	1	0	31348	11398	19950	0	0	0	186
21-27123330-G-A	3.18979E-05	8.76732E-05	0	1	1	0	31350	11406	19944	0	0	0	493
21-27123336-T-C	0.001722158	0.004559004	0.000100251	54	52	2	31356	11406	19950	0	0	0	124
21-27123349-A-G	0.001275429	0.003507541	0	40	40	0	31362	11404	19958	1	1	0	335
21-27123355-A-G	3.19E-05	0	5.01404E-05	1	0	1	31348	11404	19944	0	0	0	241
21-27123367-T-A	3.19101E-05	0	5.01605E-05	1	0	1	31338	11402	19936	0	0	0	141
21-27123378-CAG-C	0.000127641	0.000351	0	4	4	0	31338	11396	19942	0	0	0	66
21-27123425-A-G	3.19816E-05	0	5.0317E-05	1	0	1	31268	11394	19874	0	0	0	344
21-27123425-A-T	0.999968018	1	0.999949683	31267	11394	19873	31268	11394	19874	15633	5697	9936	361
21-27123438-C-T	9.60492E-05	0.000263343	0	3	3	0	31234	11392	19842	0	0	0	416
21-27123453-C-T	3.20123E-05	0	5.0388E-05	1	0	1	31238	11392	19846	0	0	0	292
21-27123465-GATAA-G	3.20287E-05	0	5.04236E-05	1	0	1	31222	11390	19832	0	0	0	160
21-27123475-AG-A	6.40164E-05	0	0.000100796	2	0	2	31242	11400	19842	0	0	0	107
21-27123515-CTG-C	0.000419301	0.001057455	5.08751E-05	13	12	1	31004	11348	19656	0	0	0	217
21-27123526-G-C	3.22768E-05	8.80437E-05	0	1	1	0	30982	11358	19624	0	0	0	155
21-27123528-A-G	6.43832E-05	0.000175963	0	2	2	0	31064	11366	19698	0	0	0	335
21-27123539-G-C	3.26541E-05	8.85426E-05	0	1	1	0	30624	11294	19330	0	0	0	376
21-27123561-T-C	4.24016E-05	0.000115048	0	1	1	0	23584	8692	14892	0	0	0	234
21-27123583-A-AG	0.844632213	0.849707913	0.841651071	25790	9600	16190	30534	11298	19236	10920	4076	6844	70
21-27123613-TAAATC-T	3.31126E-05	8.85426E-05	0	1	1	0	30200	11294	18906	0	0	0	464
21-27123616-A-G	3.31214E-05	0	5.28989E-05	1	0	1	30192	11288	18904	0	0	0	339
21-27123622-A-AT	0.000464407	0.001240695	0	14	14	0	30146	11284	18862	0	0	0	377
21-27123623-T-G	3.32336E-05	0	5.31745E-05	1	0	1	30090	11284	18806	0	0	0	176
21-27123625-A-T	0.000465054	0.001241135	0	14	14	0	30104	11280	18824	0	0	0	150
21-27123626-GA-G	0.00046729	0.001243339	0	14	14	0	29960	11260	18700	0	0	0	384
21-27123639-A-G	3.33957E-05	8.88731E-05	0	1	1	0	29944	11252	18692	0	0	0	244
21-27123644-G-A	0.002988784	0.007926612	0	89	89	0	29778	11228	18550	1	1	0	244
21-27123645-G-T	0.000100637	8.89996E-05	0.000107677	3	1	2	29810	11236	18574	0	0	0	86
21-27123651-TGAG-T	6.70646E-05	0	0.000107573	2	0	2	29822	11230	18592	0	0	0	124
21-27123652-G-C	6.71547E-05	0.000178476	0	2	2	0	29782	11206	18576	0	0	0	467
21-27123657-G-A	0.000774933	0.001973448	5.39607E-05	23	22	1	29680	11148	18532	0	0	0	365
21-27123657-G-T	3.36927E-05	0	5.39607E-05	1	0	1	29680	11148	18532	0	0	0	252
21-27123673-ATTAT-A	0.041661058	0.108529202	0.001027916	1238	1219	19	29716	11232	18484	82	82	0	255
21-27123675-T-G	3.37587E-05	0	5.42947E-05	1	0	1	29622	11204	18418	0	0	0	365
21-27123692-T-C	3.36338E-05	8.87942E-05	0	1	1	0	29732	11262	18470	0	0	0	461
21-27123732-C-G	3.31829E-05	8.87154E-05	0	1	1	0	30136	11272	18864	0	0	0	493
21-27123735-G-A	3.31323E-05	8.85897E-05	0	1	1	0	30182	11288	18894	0	0	0	208
21-27123759-G-A	6.60066E-05	0.000177022	0	2	2	0	30300	11298	19002	0	0	0	389
21-27123771-T-C	3.26861E-05	0	5.19534E-05	1	0	1	30594	11346	19248	0	0	0	53
21-27123789-T-A	3.26073E-05	8.80902E-05	0	1	1	0	30668	11352	19316	0	0	0	168
21-27123796-T-A	3.2586E-05	8.80747E-05	0	1	1	0	30688	11354	19334	0	0	0	137
21-27123811-A-AT	3.25882E-05	8.81057E-05	0	1	1	0	30686	11350	19336	0	0	0	178
21-27123826-C-T	3.25478E-05	0	5.15517E-05	1	0	1	30724	11326	19398	0	0	0	349
21-27123845-A-G	0.000162148	0.000352361	5.13242E-05	5	4	1	30836	11352	19484	0	0	0	140
21-27123854-T-G	3.24423E-05	0	5.13716E-05	1	0	1	30824	11358	19466	0	0	0	332
21-27123856-T-G	3.24423E-05	0	5.13558E-05	1	0	1	30824	11352	19472	0	0	0	130
21-27123890-T-C	3.22872E-05	8.79353E-05	0	1	1	0	30972	11372	19600	0	0	0	49
21-27123936-C-T	9.65313E-05	0.00026362	0	3	3	0	31078	11380	19698	0	0	0	90
21-27123938-C-T	9.6463E-05	0	0.000152145	3	0	3	31100	11382	19718	0	0	0	90
21-27123952-C-T	0.001418165	0.003867112	0	44	44	0	31026	11378	19648	0	0	0	327
21-27123963-TTTA-T	6.42302E-05	8.77193E-05	5.06637E-05	2	1	1	31138	11400	19738	0	0	0	379
21-27123965-T-C	3.21357E-05	0	5.07048E-05	1	0	1	31118	11396	19722	0	0	0	149
21-27123974-G-A	3.22269E-05	0	5.08699E-05	1	0	1	31030	11372	19658	0	0	0	118
21-27123979-G-T	3.22206E-05	8.80282E-05	0	1	1	0	31036	11360	19676	0	0	0	389
21-27123980-G-T	6.43376E-05	0	0.000101554	2	0	2	31086	11392	19694	0	0	0	162
21-27123987-T-G	3.21027E-05	0	5.06227E-05	1	0	1	31150	11396	19754	0	0	0	92
21-27123991-T-A	3.20883E-05	8.77501E-05	0	1	1	0	31164	11396	19768	0	0	0	255
21-27124015-G-A	9.63267E-05	0.000175747	5.0597E-05	3	2	1	31144	11380	19764	0	0	0	410
21-27124018-G-A	9.62032E-05	0.000175747	5.04948E-05	3	2	1	31184	11380	19804	0	0	0	20
21-27124021-A-G	0.000480215	0.000351062	0.00055438	15	4	11	31236	11394	19842	0	0	0	359
21-27124034-CTT-C	3.21461E-05	0	5.06175E-05	1	0	1	31108	11352	19756	0	0	0	54
21-27124062-G-C	0.023503042	0.06390647	0.000352574	734	727	7	31230	11376	19854	29	29	0	227
21-27124109-G-A	3.19142E-05	8.77193E-05	0	1	1	0	31334	11400	19934	0	0	0	212
21-27124127-T-C	3.18634E-05	8.76117E-05	0	1	1	0	31384	11414	19970	0	0	0	252
21-27124132-G-T	0.121133691	0.14745167	0.106095602	3791	1678	2113	31296	11380	19916	244	147	97	339
21-27124173-C-T	0.040029344	0.108565912	0.000901894	1255	1237	18	31352	11394	19958	86	86	0	358
21-27124195-C-T	3.18756E-05	0	5.00902E-05	1	0	1	31372	11408	19964	0	0	0	383
21-27124228-T-A	0.080656469	0.101543318	0.068732479	2531	1158	1373	31380	11404	19976	102	60	42	347
21-27124228-TAA-T	0.000191205	0.000526131	0	6	6	0	31380	11404	19976	0	0	0	29
21-27124257-C-T	0.004205697	0.011307854	0.000150165	132	129	3	31386	11408	19978	0	0	0	63
21-27124275-C-T	3.18532E-05	8.76117E-05	0	1	1	0	31394	11414	19980	0	0	0	232
21-27124286-T-A	0.000127364	0.000262835	5.002E-05	4	3	1	31406	11414	19992	0	0	0	480
21-27124325-T-C	3.18451E-05	8.76271E-05	0	1	1	0	31402	11412	19990	0	0	0	326
21-27124347-A-G	3.18593E-05	0	5.00551E-05	1	0	1	31388	11410	19978	0	0	0	122
21-27124370-A-G	3.18654E-05	0	5.0045E-05	1	0	1	31382	11400	19982	0	0	0	475
21-27124395-G-A	3.18634E-05	8.76885E-05	0	1	1	0	31384	11404	19980	0	0	0	234
21-27124419-G-A	3.18512E-05	0	5.0045E-05	1	0	1	31396	11414	19982	0	0	0	209
21-27124469-T-C	9.55718E-05	0	0.000150135	3	0	3	31390	11408	19982	0	0	0	326
21-27124496-T-C	3.18471E-05	0	5.002E-05	1	0	1	31400	11408	19992	0	0	0	69
21-27124505-A-G	3.18471E-05	0	5.0025E-05	1	0	1	31400	11410	19990	0	0	0	175
21-27124529-C-T	0.003281927	0.009031919	0	103	103	0	31384	11404	19980	2	2	0	141
21-27124599-A-C	3.1837E-05	0	5.0015E-05	1	0	1	31410	11416	19994	0	0	0	485
21-27124609-C-T	0.000350252	0.000963898	0	11	11	0	31406	11412	19994	0	0	0	484
21-27124614-G-GTT	3.1839E-05	8.76424E-05	0	1	1	0	31408	11410	19998	0	0	0	405
21-27124628-A-G	3.18492E-05	8.76271E-05	0	1	1	0	31398	11412	19986	0	0	0	439
21-27124632-T-G	3.1839E-05	8.76117E-05	0	1	1	0	31408	11414	19994	0	0	0	227
21-27124635-A-C	0.000159195	8.76117E-05	0.00020006	5	1	4	31408	11414	19994	0	0	0	357
21-27124649-G-A	3.18431E-05	8.76271E-05	0	1	1	0	31404	11412	19992	0	0	0	410
21-27124660-G-A	3.18471E-05	0	5.0025E-05	1	0	1	31400	11410	19990	0	0	0	200
21-27124666-C-T	0.000350296	8.76271E-05	0.00050025	11	1	10	31402	11412	19990	0	0	0	342
21-27124691-C-T	6.36902E-05	0.000175285	0	2	2	0	31402	11410	19992	0	0	0	209
21-27124694-A-C	3.18431E-05	0	5.002E-05	1	0	1	31404	11412	19992	0	0	0	440
21-27124704-A-G	3.18451E-05	0	5.002E-05	1	0	1	31402	11410	19992	0	0	0	389
21-27124722-G-A	9.55231E-05	0.000262835	0	3	3	0	31406	11414	19992	0	0	0	255
21-27124729-G-A	3.18471E-05	0	5.0035E-05	1	0	1	31400	11414	19986	0	0	0	113
21-27124733-A-C	3.1841E-05	8.76271E-05	0	1	1	0	31406	11412	19994	0	0	0	432
21-27124734-G-A	3.18471E-05	0	5.0025E-05	1	0	1	31400	11410	19990	0	0	0	352
21-27124736-A-C	3.18431E-05	8.76271E-05	0	1	1	0	31404	11412	19992	0	0	0	459
21-27124762-T-G	3.18552E-05	8.76578E-05	0	1	1	0	31392	11408	19984	0	0	0	162
21-27124771-G-GGT	3.18573E-05	0	5.0045E-05	1	0	1	31390	11408	19982	0	0	0	411
21-27124780-A-C	6.37105E-05	0.000175346	0	2	2	0	31392	11406	19986	0	0	0	303
21-27124794-G-A	3.18552E-05	0	5.003E-05	1	0	1	31392	11404	19988	0	0	0	403
21-27124794-G-C	3.18552E-05	0	5.003E-05	1	0	1	31392	11404	19988	0	0	0	96
21-27124798-G-A	9.55657E-05	0	0.000150105	3	0	3	31392	11406	19986	0	0	0	101
21-27124799-A-C	3.18471E-05	8.76578E-05	0	1	1	0	31400	11408	19992	0	0	0	41
21-27124801-G-C	3.18532E-05	8.76732E-05	0	1	1	0	31394	11406	19988	0	0	0	83
21-27124803-T-C	0.000828395	0.002280702	0	26	26	0	31386	11400	19986	0	0	0	394
21-27124818-G-A	0.993312102	0.981676311	0.999949985	31190	11197	19993	31400	11406	19994	15491	5495	9996	44
21-27124824-C-T	0.161286206	0.256281849	0.107132125	5056	2917	2139	31348	11382	19966	484	381	103	238
21-27124825-A-G	3.18532E-05	8.76732E-05	0	1	1	0	31394	11406	19988	0	0	0	320
21-27124826-T-C	3.18613E-05	0	5.00501E-05	1	0	1	31386	11406	19980	0	0	0	367
21-27124848-C-T	3.18512E-05	8.76271E-05	0	1	1	0	31396	11412	19984	0	0	0	424
21-27124850-G-GC	3.18552E-05	8.76578E-05	0	1	1	0	31392	11408	19984	0	0	0	279
21-27124867-A-T	3.18492E-05	0	5.0035E-05	1	0	1	31398	11412	19986	0	0	0	479
21-27124876-A-G	3.18431E-05	0	5.002E-05	1	0	1	31404	11412	19992	0	0	0	186
21-27124880-G-A	6.37064E-05	0.000175316	0	2	2	0	31394	11408	19986	0	0	0	176
21-27124892-G-C	0.003026634	0.000613712	0.004403964	95	7	88	31388	11406	19982	0	0	0	310
21-27124902-G-T	0.000541505	0.001489921	0	17	17	0	31394	11410	19984	0	0	0	43
21-27124938-A-G	3.18634E-05	8.76271E-05	0	1	1	0	31384	11412	19972	0	0	0	19
21-27124970-A-T	0.00038219	0.00105134	0	12	12	0	31398	11414	19984	0	0	0	243
21-27124973-G-C	3.18593E-05	0	5.00551E-05	1	0	1	31388	11410	19978	0	0	0	235
21-27124981-T-A	0.000159236	0.000438135	0	5	5	0	31400	11412	19988	0	0	0	36
21-27124983-T-C	3.18532E-05	0	5.0045E-05	1	0	1	31394	11412	19982	0	0	0	396
21-27124990-A-G	3.18471E-05	8.76424E-05	0	1	1	0	31400	11410	19990	0	0	0	191
21-27125015-G-A	0.000350385	0.000876271	5.0045E-05	11	10	1	31394	11412	19982	0	0	0	491
21-27125038-A-G	3.18532E-05	0	5.004E-05	1	0	1	31394	11410	19984	0	0	0	123
21-27125047-T-A	0.007738361	0.021026809	0.00015009	243	240	3	31402	11414	19988	3	3	0	370
21-27125057-T-G	3.18451E-05	8.76271E-05	0	1	1	0	31402	11412	19990	0	0	0	141
21-27125060-A-G	3.18431E-05	8.76424E-05	0	1	1	0	31404	11410	19994	0	0	0	19
21-27125064-C-T	0.039873781	0.108195858	0.000900991	1251	1233	18	31374	11396	19978	82	82	0	25
21-27125084-T-C	6.3743E-05	0.000175377	0	2	2	0	31376	11404	19972	0	0	0	224
21-27125102-T-A	0.000318573	0.000876424	0	10	10	0	31390	11410	19980	0	0	0	117
21-27125109-G-A	3.18715E-05	0	5.00851E-05	1	0	1	31376	11410	19966	0	0	0	3
21-27125110-C-A	3.18552E-05	0	5.00551E-05	1	0	1	31392	11414	19978	0	0	0	43
21-27125117-T-C	3.18613E-05	0	5.00601E-05	1	0	1	31386	11410	19976	0	0	0	27
21-27125137-A-G	3.18593E-05	8.76271E-05	0	1	1	0	31388	11412	19976	0	0	0	444
21-27125146-G-A	3.18593E-05	8.76271E-05	0	1	1	0	31388	11412	19976	0	0	0	437
21-27125156-A-T	3.18573E-05	0	5.00601E-05	1	0	1	31390	11414	19976	0	0	0	229
21-27125159-A-G	3.18532E-05	0	5.00501E-05	1	0	1	31394	11414	19980	0	0	0	443
21-27125199-A-G	3.18532E-05	0	5.004E-05	1	0	1	31394	11410	19984	0	0	0	418
21-27125204-A-C	6.37024E-05	0	0.00010007	2	0	2	31396	11410	19986	0	0	0	171
21-27125210-G-C	6.37064E-05	0	0.00010004	2	0	2	31394	11402	19992	0	0	0	39
21-27125216-A-G	3.18451E-05	0	5.0025E-05	1	0	1	31402	11412	19990	0	0	0	392
21-27125232-A-G	6.37146E-05	0.000175377	0	2	2	0	31390	11404	19986	0	0	0	342
21-27125236-G-A	6.37105E-05	8.76732E-05	5.0035E-05	2	1	1	31392	11406	19986	0	0	0	282
21-27125260-G-T	0.006752883	0.018232819	0.00020014	212	208	4	31394	11408	19986	3	3	0	423
21-27125266-GGACT-G	3.18573E-05	8.76885E-05	0	1	1	0	31390	11404	19986	0	0	0	196
21-27125288-T-C	6.37511E-05	0.000175685	0	2	2	0	31372	11384	19988	0	0	0	92
21-27125311-A-G	3.18512E-05	8.76424E-05	0	1	1	0	31396	11410	19986	0	0	0	20
21-27125323-C-G	0.000127421	8.76732E-05	0.000150105	4	1	3	31392	11406	19986	0	0	0	121
21-27125378-T-C	0.000191107	0.000525855	0	6	6	0	31396	11410	19986	0	0	0	396
21-27125407-A-G	0.001178569	0.00324277	0	37	37	0	31394	11410	19984	0	0	0	180
21-27125414-C-T	0.02307055	0.062938904	0.000350175	724	717	7	31382	11392	19990	30	30	0	436
21-27125418-C-T	0.00035043	0.000964405	0	11	11	0	31390	11406	19984	0	0	0	499
21-27125454-A-G	0.000477677	0.001314636	0	15	15	0	31402	11410	19992	0	0	0	234
21-27125489-A-G	3.18451E-05	8.76578E-05	0	1	1	0	31402	11408	19994	0	0	0	353
21-27125512-G-T	6.37267E-05	0.000175439	0	2	2	0	31384	11400	19984	0	0	0	368
21-27125523-G-A	0.000159449	0.00043875	0	5	5	0	31358	11396	19962	0	0	0	388
21-27125560-A-T	6.37186E-05	0.000175469	0	2	2	0	31388	11398	19990	0	0	0	476
21-27125572-A-C	9.55779E-05	0.000263158	0	3	3	0	31388	11400	19988	0	0	0	86
21-27125586-G-A	6.37105E-05	8.77039E-05	5.0025E-05	2	1	1	31392	11402	19990	0	0	0	483
21-27125592-C-T	6.37511E-05	0	0.00010008	2	0	2	31372	11388	19984	0	0	0	146
21-27125622-G-A	0.001688221	0.000526039	0.002351411	53	6	47	31394	11406	19988	0	0	0	285
21-27125625-T-C	0.000159266	0	0.00025015	5	0	5	31394	11406	19988	0	0	0	26
21-27125631-C-T	3.18674E-05	0	5.0045E-05	1	0	1	31380	11398	19982	0	0	0	474
21-27125670-T-G	3.1841E-05	0	5.002E-05	1	0	1	31406	11414	19992	0	0	0	228
21-27125682-A-G	3.18451E-05	8.76271E-05	0	1	1	0	31402	11412	19990	0	0	0	187
21-27125703-G-A	6.37146E-05	0.000175285	0	2	2	0	31390	11410	19980	0	0	0	291
21-27125708-G-A	3.18471E-05	8.76117E-05	0	1	1	0	31400	11414	19986	0	0	0	66
21-27125722-A-C	3.18431E-05	0	5.0005E-05	1	0	1	31404	11406	19998	0	0	0	80
21-27125751-G-C	3.18512E-05	0	5.002E-05	1	0	1	31396	11404	19992	0	0	0	201
21-27125772-T-C	9.56084E-05	0.000263204	0	3	3	0	31378	11398	19980	0	0	0	397
21-27125779-A-G	3.18471E-05	8.76578E-05	0	1	1	0	31400	11408	19992	0	0	0	483
21-27125805-A-G	0.000254761	0.000438212	0.00015006	8	5	3	31402	11410	19992	0	0	0	403
21-27125810-A-C	3.1839E-05	0	5.0015E-05	1	0	1	31408	11414	19994	0	0	0	291
21-27125828-A-G	6.36862E-05	0.000175254	0	2	2	0	31404	11412	19992	0	0	0	238
21-27125829-T-C	0.000414039	0.001139152	0	13	13	0	31398	11412	19986	0	0	0	461
21-27125848-T-G	6.3743E-05	0.000175469	0	2	2	0	31376	11398	19978	0	0	0	159
21-27125881-ATGC-A	3.18512E-05	8.77347E-05	0	1	1	0	31396	11398	19998	0	0	0	13
21-27125890-A-C	0.000127518	0.000351803	0	4	4	0	31368	11370	19998	0	0	0	290
21-27125892-A-G	3.18878E-05	0	5.001E-05	1	0	1	31360	11364	19996	0	0	0	165
21-27125910-CTG-C	0.02169619	0.059329472	0.000250075	681	676	5	31388	11394	19994	23	23	0	201
21-27125912-G-A	0.002741473	0.00087858	0.003802281	86	10	76	31370	11382	19988	1	0	1	104
21-27125929-A-T	6.36902E-05	0.000175285	0	2	2	0	31402	11410	19992	0	0	0	412
21-27125958-CAG-C	6.37592E-05	0.000175408	0	2	2	0	31368	11402	19966	0	0	0	328
21-27125966-A-T	3.18573E-05	0	5.0045E-05	1	0	1	31390	11408	19982	0	0	0	176
21-27125967-CTA-C	3.18715E-05	8.77039E-05	0	1	1	0	31376	11402	19974	0	0	0	141
21-27125984-A-C	3.18471E-05	0	5.003E-05	1	0	1	31400	11412	19988	0	0	0	228
21-27125987-C-T	0.000510074	0.001315789	5.00801E-05	16	15	1	31368	11400	19968	0	0	0	118
21-27126038-G-GC	3.18431E-05	8.76578E-05	0	1	1	0	31404	11408	19996	0	0	0	473
21-27126044-G-A	3.18492E-05	8.76732E-05	0	1	1	0	31398	11406	19992	0	0	0	56
21-27126082-G-A	0.000191071	0.000175254	0.0002001	6	2	4	31402	11412	19990	0	0	0	152
21-27126105-G-C	3.18593E-05	8.76578E-05	0	1	1	0	31388	11408	19980	0	0	0	202
21-27126106-A-C	3.1839E-05	8.76271E-05	0	1	1	0	31408	11412	19996	0	0	0	189
21-27126118-C-T	3.18776E-05	0	5.00902E-05	1	0	1	31370	11406	19964	0	0	0	99
21-27126130-C-CT	3.18735E-05	8.76732E-05	0	1	1	0	31374	11406	19968	0	0	0	458
21-27126138-AT-A	3.20801E-05	0	5.04541E-05	1	0	1	31172	11352	19820	0	0	0	482
21-27126158-A-G	3.18654E-05	0	5.00601E-05	1	0	1	31382	11406	19976	0	0	0	466
21-27126160-G-C	3.18634E-05	0	5.00651E-05	1	0	1	31384	11410	19974	0	0	0	420
21-27126160-G-T	3.18634E-05	0	5.00651E-05	1	0	1	31384	11410	19974	0	0	0	403
21-27126162-T-G	3.18573E-05	0	5.00501E-05	1	0	1	31390	11410	19980	0	0	0	206
21-27126165-A-T	3.18674E-05	0	5.00601E-05	1	0	1	31380	11404	19976	0	0	0	438
21-27126199-A-C	3.18471E-05	0	5.0035E-05	1	0	1	31400	11414	19986	0	0	0	43
21-27126199-A-G	3.18471E-05	0	5.0035E-05	1	0	1	31400	11414	19986	0	0	0	142
21-27126201-T-A	3.18532E-05	8.76732E-05	0	1	1	0	31394	11406	19988	0	0	0	119
21-27126210-A-G	3.18654E-05	0	5.00601E-05	1	0	1	31382	11406	19976	0	0	0	462
21-27126233-T-C	3.18552E-05	8.76732E-05	0	1	1	0	31392	11406	19986	0	0	0	111
21-27126265-C-T	3.19081E-05	8.77655E-05	0	1	1	0	31340	11394	19946	0	0	0	367
21-27126276-A-C	3.18735E-05	0	5.0035E-05	1	0	1	31374	11388	19986	0	0	0	433
21-27126282-T-A	0.000286752	8.77655E-05	0.00040016	9	1	8	31386	11394	19992	0	0	0	438
21-27126292-A-G	9.55901E-05	0	0.00015012	3	0	3	31384	11400	19984	0	0	0	443
21-27126311-A-G	3.18695E-05	8.76732E-05	0	1	1	0	31378	11406	19972	0	0	0	404
21-27126322-A-G	3.18695E-05	8.76885E-05	0	1	1	0	31378	11404	19974	0	0	0	143
21-27126324-T-C	6.37186E-05	0	0.00010008	2	0	2	31388	11404	19984	0	0	0	237
21-27126348-G-A	0.00019129	0.000526501	0	6	6	0	31366	11396	19970	0	0	0	412
21-27126363-A-C	0.000254728	0.000701016	0	8	8	0	31406	11412	19994	0	0	0	245
21-27126370-A-C	3.18451E-05	8.75964E-05	0	1	1	0	31402	11416	19986	0	0	0	208
21-27126377-CG-C	3.18593E-05	8.76732E-05	0	1	1	0	31388	11406	19982	0	0	0	270
21-27126380-C-G	0.19707121	0.35426915	0.10741483	6177	4033	2144	31344	11384	19960	849	745	104	9
21-27126409-A-G	0.121335712	0.147868795	0.106195576	3808	1686	2122	31384	11402	19982	248	150	98	35
21-27126449-A-G	3.1839E-05	0	5.0015E-05	1	0	1	31408	11414	19994	0	0	0	310
21-27126476-A-G	6.36983E-05	0.000175223	0	2	2	0	31398	11414	19984	0	0	0	311
21-27126486-A-G	0.001973894	0.005430974	0	62	62	0	31410	11416	19994	1	1	0	231
21-27126522-A-G	3.18431E-05	8.76117E-05	0	1	1	0	31404	11414	19990	0	0	0	13
21-27126530-T-C	3.18471E-05	8.76271E-05	0	1	1	0	31400	11412	19988	0	0	0	340
21-27126558-T-A	6.37877E-05	0.000176025	0	2	2	0	31354	11362	19992	0	0	0	249
21-27126576-T-TA	0.040073904	0.108695652	0.000900721	1258	1240	18	31392	11408	19984	86	86	0	431
21-27126595-G-T	3.18654E-05	0	5.00601E-05	1	0	1	31382	11406	19976	0	0	0	269
21-27126597-A-G	3.18613E-05	0	5.00601E-05	1	0	1	31386	11410	19976	0	0	0	466
21-27126602-A-G	9.56389E-05	0.000263019	0	3	3	0	31368	11406	19962	0	0	0	171
21-27126607-T-C	0.000860092	0	0.001351216	27	0	27	31392	11410	19982	0	0	0	234
21-27126620-T-C	6.36983E-05	0.000175223	0	2	2	0	31398	11414	19984	0	0	0	194
21-27126636-A-G	3.18613E-05	0	5.00551E-05	1	0	1	31386	11408	19978	0	0	0	23
21-27126640-T-C	3.18715E-05	0	5.00851E-05	1	0	1	31376	11410	19966	0	0	0	12
21-27126643-A-G	3.18756E-05	0	5.00851E-05	1	0	1	31372	11406	19966	0	0	0	101
21-27126665-T-C	3.18715E-05	8.76578E-05	0	1	1	0	31376	11408	19968	0	0	0	23
21-27126685-G-A	3.19468E-05	0	5.0226E-05	1	0	1	31302	11392	19910	0	0	0	19
21-27126702-TC-T	0.000191461	8.77501E-05	0.000250727	6	1	5	31338	11396	19942	0	0	0	310
21-27126718-G-T	3.19142E-05	0	5.01756E-05	1	0	1	31334	11404	19930	0	0	0	139
21-27126736-T-A	3.19305E-05	8.76732E-05	0	1	1	0	31318	11406	19912	0	0	0	314
21-27126738-T-A	0.092500319	0.133491311	0.069046902	2896	1521	1375	31308	11394	19914	148	105	43	195
21-27126758-C-T	3.19857E-05	0	5.03373E-05	1	0	1	31264	11398	19866	0	0	0	29
21-27126760-T-C	0.000542923	0.000175439	0.000753315	17	2	15	31312	11400	19912	0	0	0	311
21-27126774-A-G	3.19775E-05	8.78117E-05	0	1	1	0	31272	11388	19884	0	0	0	460
21-27126809-C-T	3.19285E-05	0	5.02008E-05	1	0	1	31320	11400	19920	0	0	0	77
21-27126834-G-C	0.000287669	0.000790306	0	9	9	0	31286	11388	19898	0	0	0	486
21-27126837-C-G	3.19448E-05	0	5.02361E-05	1	0	1	31304	11398	19906	0	0	0	246
21-27126838-T-C	3.1902E-05	0	5.01555E-05	1	0	1	31346	11408	19938	0	0	0	130
21-27126843-TTTTG-T	6.3804E-05	0	0.000100301	2	0	2	31346	11406	19940	0	0	0	374
21-27126847-G-A	3.2173E-05	0	5.06791E-05	1	0	1	31082	11350	19732	0	0	0	268
21-27126854-C-T	0.033098592	0.008170796	0.047386444	1034	93	941	31240	11382	19858	22	1	21	1
21-27126879-A-G	3.20307E-05	8.77501E-05	0	1	1	0	31220	11396	19824	0	0	0	292
21-27126888-A-G	0.000127877	0.000350754	0	4	4	0	31280	11404	19876	0	0	0	382
21-27126891-G-A	6.40492E-05	0.0001755	0	2	2	0	31226	11396	19830	0	0	0	121
21-27126898-C-A	6.39345E-05	0	0.000100563	2	0	2	31282	11394	19888	0	0	0	166
21-27126911-GA-G	3.2039E-05	8.80282E-05	0	1	1	0	31212	11360	19852	0	0	0	336
21-27126918-T-C	3.20102E-05	0	5.02513E-05	1	0	1	31240	11340	19900	0	0	0	118
21-27126923-T-C	0.000193262	0.000533713	0	6	6	0	31046	11242	19804	0	0	0	236
21-27126924-ATATATT-A	3.23269E-05	8.94134E-05	0	1	1	0	30934	11184	19750	0	0	0	357
21-27126926-A-AT	0.002558787	0.007095384	0	79	79	0	30874	11134	19740	1	1	0	422
21-27126926-A-T	3.23897E-05	8.9815E-05	0	1	1	0	30874	11134	19740	0	0	0	476
21-27126927-TA-T	3.23792E-05	0	5.06534E-05	1	0	1	30884	11142	19742	0	0	0	424
21-27126928-A-AT	0.007082245	0.018663349	0.000361048	217	210	7	30640	11252	19388	3	3	0	307
21-27126928-A-ATT	0.068211488	0.098471383	0.050649887	2090	1108	982	30640	11252	19388	80	56	24	2
21-27126928-A-T	3.26371E-05	8.88731E-05	0	1	1	0	30640	11252	19388	0	0	0	87
21-27126928-AT-A	3.26371E-05	8.88731E-05	0	1	1	0	30640	11252	19388	0	0	0	52
21-27126929-T-TA	0.018568033	0.006608884	0.024805063	500	61	439	26928	9230	17698	5	0	5	241
21-27126930-T-A	0.032424812	0.084632312	0.002276819	966	923	43	29792	10906	18886	47	47	0	167
21-27126992-T-C	3.18471E-05	0	5.0025E-05	1	0	1	31400	11410	19990	0	0	0	113
21-27126998-T-C	0.000254826	0.000350385	0.00020022	8	4	4	31394	11416	19978	0	0	0	176
21-27127025-C-G	9.57671E-05	0.00026325	0	3	3	0	31326	11396	19930	0	0	0	494
21-27127027-C-A	3.18817E-05	0	5.01153E-05	1	0	1	31366	11412	19954	0	0	0	137
21-27127029-AG-A	3.18735E-05	8.76578E-05	0	1	1	0	31374	11408	19966	0	0	0	113
21-27127041-T-C	3.1841E-05	8.76117E-05	0	1	1	0	31406	11414	19992	0	0	0	288
21-27127060-A-G	0.001243543	0.000701754	0.001552951	39	8	31	31362	11400	19962	1	0	1	142
21-27127089-A-G	3.18492E-05	8.76732E-05	0	1	1	0	31398	11406	19992	0	0	0	125
21-27127091-A-G	0.002070196	0.005349	0.00020006	65	61	4	31398	11404	19994	2	2	0	98
21-27127095-G-C	0.000191156	0.000526039	0	6	6	0	31388	11406	19982	0	0	0	280
21-27127135-G-A	3.2078E-05	8.81213E-05	0	1	1	0	31174	11348	19826	0	0	0	151
21-27127144-C-G	6.37674E-05	0	0.00010021	2	0	2	31364	11406	19958	0	0	0	330
21-27127154-G-A	3.18613E-05	8.76732E-05	0	1	1	0	31386	11406	19980	0	0	0	48
21-27127197-A-G	3.19898E-05	8.79972E-05	0	1	1	0	31260	11364	19896	0	0	0	327
21-27127200-A-G	9.59202E-05	0.000264038	0	3	3	0	31276	11362	19914	0	0	0	21
21-27127204-A-C	3.21213E-05	0	5.0449E-05	1	0	1	31132	11310	19822	0	0	0	449
21-27127293-C-T	3.19122E-05	8.77501E-05	0	1	1	0	31336	11396	19940	0	0	0	273
21-27127297-C-T	0.000127804	0.000175562	0.000100472	4	2	2	31298	11392	19906	0	0	0	185
21-27127333-G-A	3.18593E-05	8.76578E-05	0	1	1	0	31388	11408	19980	0	0	0	150
21-27127345-A-C	3.18593E-05	8.76578E-05	0	1	1	0	31388	11408	19980	0	0	0	182
21-27127406-C-T	0.00431062	0.010795155	0.000602289	135	123	12	31318	11394	19924	0	0	0	420
21-27127407-G-A	3.18939E-05	8.77039E-05	0	1	1	0	31354	11402	19952	0	0	0	260
21-27127433-A-G	0.000286862	0	0.00045045	9	0	9	31374	11394	19980	0	0	0	4
21-27127435-G-A	3.19E-05	0	5.01052E-05	1	0	1	31348	11390	19958	0	0	0	65
21-27127438-G-C	6.38692E-05	0	0.000100371	2	0	2	31314	11388	19926	0	0	0	474
21-27127439-A-T	3.18857E-05	8.77963E-05	0	1	1	0	31362	11390	19972	0	0	0	384
21-27127445-C-T	0.000064	8.79507E-05	5.03018E-05	2	1	1	31250	11370	19880	0	0	0	16
21-27127451-A-AT	3.19734E-05	8.79662E-05	0	1	1	0	31276	11368	19908	0	0	0	217
21-27127460-T-G	3.20513E-05	0	5.03778E-05	1	0	1	31200	11350	19850	0	0	0	463
21-27127494-T-C	6.42178E-05	0.000175994	0	2	2	0	31144	11364	19780	0	0	0	98
21-27127509-C-T	0.033265097	0.09017402	0.000704013	1040	1026	14	31264	11378	19886	55	55	0	389
21-27127529-G-A	3.19326E-05	0	5.01907E-05	1	0	1	31316	11392	19924	0	0	0	227
21-27127550-A-T	0.000767312	8.77501E-05	0.001156825	24	1	23	31278	11396	19882	0	0	0	317
21-27127569-G-A	0.000128131	0	0.000201532	4	0	4	31218	11370	19848	0	0	0	370
21-27127586-T-C	3.21585E-05	8.81679E-05	0	1	1	0	31096	11342	19754	0	0	0	246
21-27127592-C-T	3.26371E-05	8.88573E-05	0	1	1	0	30640	11254	19386	0	0	0	242
21-27127635-A-G	3.19959E-05	0	5.02664E-05	1	0	1	31254	11360	19894	0	0	0	274
21-27127637-C-T	3.21027E-05	0	5.05357E-05	1	0	1	31150	11362	19788	0	0	0	418
21-27127638-C-T	3.20986E-05	0	5.04999E-05	1	0	1	31154	11352	19802	0	0	0	299
21-27127646-C-T	0.000514271	0.001412679	0	16	16	0	31112	11326	19786	0	0	0	243
21-27127676-G-C	3.2202E-05	0	5.06791E-05	1	0	1	31054	11322	19732	0	0	0	417
21-27127677-C-T	0.28810786	0.487893025	0.174653669	8804	5400	3404	30558	11068	19490	1694	1397	297	215
21-27127691-G-C	3.25034E-05	8.90155E-05	0	1	1	0	30766	11234	19532	0	0	0	94
21-27127705-C-G	3.32292E-05	8.99766E-05	0	1	1	0	30094	11114	18980	0	0	0	201
21-27127715-C-T	0.000300923	0.000813155	0	9	9	0	29908	11068	18840	0	0	0	320
21-27127737-ACTGT-A	0.000276453	0	0.000425849	8	0	8	28938	10152	18786	0	0	0	200
21-27127739-TGTC-T	4.52161E-05	0	7.17669E-05	1	0	1	22116	8182	13934	0	0	0	233
21-27127741-T-C	4.8539E-05	0.00013217	0	1	1	0	20602	7566	13036	0	0	0	370
21-27127743-T-TA	0.004699248	0.00148368	0.007609669	60	9	51	12768	6066	6702	0	0	0	427
21-27127743-T-TAA	0.009163534	0.013517969	0.005222322	117	82	35	12768	6066	6702	2	2	0	243
21-27127743-TA-T	0.15037594	0.190735246	0.113846613	1920	1157	763	12768	6066	6702	96	74	22	278
21-27127743-TAA-T	0.002192982	0.002637652	0.00179051	28	16	12	12768	6066	6702	0	0	0	463
21-27127743-TAAA-T	0.232926065	0.305308276	0.167412713	2974	1852	1122	12768	6066	6702	233	202	31	347
21-27127743-TAAAAA-T	0.01856203	0.004286185	0.031483139	237	26	211	12768	6066	6702	1	0	1	193
21-27127759-A-G	3.23666E-05	8.86682E-05	0	1	1	0	30896	11278	19618	0	0	0	448
21-27127764-A-AAC	0.000140233	0.000384615	0	4	4	0	28524	10400	18124	0	0	0	248
21-27127764-A-AC	0.010096761	0.027596154	5.51755E-05	288	287	1	28524	10400	18124	8	8	0	338
21-27127764-A-AGG	0.071027906	0.0975	0.055837563	2026	1014	1012	28524	10400	18124	91	56	35	245
21-27127764-A-C	0.00038564	0.001057692	0	11	11	0	28524	10400	18124	0	0	0	26
21-27127764-A-G	0.000175291	0.000480769	0	5	5	0	28524	10400	18124	1	1	0	143
21-27127777-G-C	3.43879E-05	0	5.48065E-05	1	0	1	29080	10834	18246	0	0	0	426
21-27127788-G-T	6.57246E-05	0.00017934	0	2	2	0	30430	11152	19278	0	0	0	402
21-27127793-A-AATATTTAT	0.000128924	0.000353732	0	4	4	0	31026	11308	19718	0	0	0	493
21-27127808-T-G	3.20574E-05	8.82457E-05	0	1	1	0	31194	11332	19862	0	0	0	376
21-27127816-A-T	9.70874E-05	0	0.000152936	3	0	3	30900	11284	19616	0	0	0	374
21-27127821-T-C	3.21316E-05	8.81679E-05	0	1	1	0	31122	11342	19780	0	0	0	35
21-27127832-G-A	3.19305E-05	8.7858E-05	0	1	1	0	31318	11382	19936	0	0	0	277
21-27127842-G-A	3.19183E-05	8.77963E-05	0	1	1	0	31330	11390	19940	0	0	0	456
21-27127854-G-T	3.1902E-05	8.78272E-05	0	1	1	0	31346	11386	19960	0	0	0	114
21-27127861-G-A	3.18959E-05	0	5.00801E-05	1	0	1	31352	11384	19968	0	0	0	476
21-27127864-T-C	3.19142E-05	0	5.00902E-05	1	0	1	31334	11370	19964	0	0	0	14
21-27127878-G-A	9.5645E-05	0.000263343	0	3	3	0	31366	11392	19974	0	0	0	63
21-27127885-A-G	6.37959E-05	0	0.00010018	2	0	2	31350	11386	19964	0	0	0	185
21-27127905-C-T	0.001148912	0.002986648	0.000100251	36	34	2	31334	11384	19950	0	0	0	162
21-27127915-G-T	3.18837E-05	8.77655E-05	0	1	1	0	31364	11394	19970	0	0	0	238
21-27127920-GA-G	0.000223172	0.000614358	0	7	7	0	31366	11394	19972	0	0	0	370
21-27127923-G-A	6.38203E-05	0	0.000100231	2	0	2	31338	11384	19954	0	0	0	366
21-27127931-C-T	0.003480204	0.009319501	0.000150406	109	106	3	31320	11374	19946	1	1	0	295
21-27127941-C-A	3.19061E-05	0	5.01102E-05	1	0	1	31342	11386	19956	0	0	0	395
21-27127946-G-A	3.19122E-05	0	5.01002E-05	1	0	1	31336	11376	19960	0	0	0	352
21-27127946-GT-G	3.19122E-05	8.79044E-05	0	1	1	0	31336	11376	19960	0	0	0	246
21-27127951-T-C	3.18979E-05	0	5.00851E-05	1	0	1	31350	11384	19966	0	0	0	299
21-27127984-G-T	3.18735E-05	0	5.00601E-05	1	0	1	31374	11398	19976	0	0	0	266
21-27127988-G-A	3.18776E-05	0	5.00601E-05	1	0	1	31370	11394	19976	0	0	0	176
21-27127996-C-G	3.18695E-05	8.77347E-05	0	1	1	0	31378	11398	19980	0	0	0	101
21-27128018-G-A	6.37267E-05	0	0.00010008	2	0	2	31384	11400	19984	0	0	0	16
21-27128020-T-C	3.18512E-05	0	5.0035E-05	1	0	1	31396	11410	19986	0	0	0	260
21-27128026-G-A	3.18735E-05	0	5.00601E-05	1	0	1	31374	11398	19976	0	0	0	27
21-27128032-C-T	0.009335372	0.025521838	0.00010008	293	291	2	31386	11402	19984	5	5	0	355
21-27128034-CAT-C	0.000286716	0.000789197	0	9	9	0	31390	11404	19986	0	0	0	161
21-27128036-T-C	3.18532E-05	8.77039E-05	0	1	1	0	31394	11402	19992	0	0	0	331
21-27128061-G-GC	3.18654E-05	0	5.0045E-05	1	0	1	31382	11400	19982	0	0	0	331
21-27128118-T-A	0.000319305	0.000879044	0	10	10	0	31318	11376	19942	0	0	0	311
21-27128118-T-G	0.288588032	0.487078059	0.17535854	9038	5541	3497	31318	11376	19942	1738	1433	305	411
21-27128123-C-T	3.18573E-05	0	5.0035E-05	1	0	1	31390	11404	19986	0	0	0	467
21-27128133-A-G	3.18471E-05	0	5.0015E-05	1	0	1	31400	11406	19994	0	0	0	353
21-27128144-T-C	3.18532E-05	8.76732E-05	0	1	1	0	31394	11406	19988	0	0	0	348
21-27128148-G-A	0.000127453	0.000350939	0	4	4	0	31384	11398	19986	0	0	0	47
21-27128166-G-A	3.18593E-05	8.77347E-05	0	1	1	0	31388	11398	19990	0	0	0	124
21-27128168-C-T	0.000254874	0	0.0004002	8	0	8	31388	11398	19990	0	0	0	326
21-27128174-C-A	3.18532E-05	8.77193E-05	0	1	1	0	31394	11400	19994	0	0	0	492
21-27128187-T-A	9.55657E-05	0.000263019	0	3	3	0	31392	11406	19986	0	0	0	401
21-27128206-C-G	6.36902E-05	0	0.00010004	2	0	2	31402	11410	19992	0	0	0	456
21-27128218-T-C	3.1841E-05	8.76424E-05	0	1	1	0	31406	11410	19996	0	0	0	30
21-27128228-C-T	0.000286606	0.000262927	0.00030012	9	3	6	31402	11410	19992	0	0	0	356
21-27128243-A-T	3.18471E-05	0	5.003E-05	1	0	1	31400	11412	19988	0	0	0	470
21-27128252-T-A	9.55414E-05	0.000262973	0	3	3	0	31400	11408	19992	0	0	0	363
21-27128259-C-G	3.18492E-05	8.76578E-05	0	1	1	0	31398	11408	19990	0	0	0	358
21-27128259-C-T	3.18492E-05	0	5.0025E-05	1	0	1	31398	11408	19990	0	0	0	278
21-27128264-A-G	0.033286615	0.090391022	0.00070042	1045	1031	14	31394	11406	19988	56	56	0	269
21-27128264-A-T	0.000668918	0.001841136	0	21	21	0	31394	11406	19988	0	0	0	275
21-27128282-C-G	3.18431E-05	8.76424E-05	0	1	1	0	31404	11410	19994	0	0	0	41
21-27128284-C-T	0.00012738	0.00035057	0	4	4	0	31402	11410	19992	0	0	0	450
21-27128290-A-G	3.18654E-05	0	5.00601E-05	1	0	1	31382	11406	19976	0	0	0	440
21-27128316-C-A	3.18512E-05	0	5.0025E-05	1	0	1	31396	11406	19990	0	0	0	294
21-27128316-C-G	3.18512E-05	0	5.0025E-05	1	0	1	31396	11406	19990	0	0	0	93
21-27128329-C-T	3.18451E-05	8.76424E-05	0	1	1	0	31402	11410	19992	0	0	0	258
21-27128345-A-G	3.18512E-05	8.76885E-05	0	1	1	0	31396	11404	19992	0	0	0	71
21-27128346-T-C	0.011144367	0.030329593	0.00020002	350	346	4	31406	11408	19998	7	7	0	211
21-27128350-C-T	3.18512E-05	0	5.0025E-05	1	0	1	31396	11406	19990	0	0	0	294
21-27128353-A-G	3.18552E-05	8.76885E-05	0	1	1	0	31392	11404	19988	0	0	0	207
21-27128354-T-C	0.000191022	0.000525855	0	6	6	0	31410	11410	20000	0	0	0	85
21-27128358-T-C	0.000318573	0	0.00050025	10	0	10	31390	11400	19990	0	0	0	493
21-27128366-T-A	0.000191107	0.000526316	0	6	6	0	31396	11400	19996	0	0	0	98
21-27128392-T-C	0.03315709	0.09011934	0.0007	1041	1027	14	31396	11396	20000	54	54	0	261
21-27128399-G-A	3.18431E-05	8.76424E-05	0	1	1	0	31404	11410	19994	0	0	0	141
21-27128413-A-T	0.000127372	0	0.00020002	4	0	4	31404	11406	19998	0	0	0	125
21-27128415-G-A	9.55171E-05	0.000262881	0	3	3	0	31408	11412	19996	0	0	0	92
21-27128422-A-G	6.36699E-05	0	0.00010002	2	0	2	31412	11416	19996	0	0	0	31
21-27128433-A-G	0.00025468	0.000700894	0	8	8	0	31412	11414	19998	0	0	0	401
21-27128459-G-T	0.000350363	0.000876732	5.0025E-05	11	10	1	31396	11406	19990	0	0	0	326
21-27128472-A-G	3.20164E-05	0	5.03525E-05	1	0	1	31234	11374	19860	0	0	0	70
21-27128499-T-G	7.52049E-05	0	0.000126904	2	0	2	26594	10834	15760	0	0	0	106
21-27128502-GT-G	0.348539326	0.182986967	0.443518238	10857	2078	8779	31150	11356	19794	2180	241	1939	266
21-27128502-GTTTT-G	6.42055E-05	0	0.000101041	2	0	2	31150	11356	19794	0	0	0	468
21-27128510-TA-T	0.001178269	0.003242201	0	37	37	0	31402	11412	19990	0	0	0	276
21-27128539-T-C	3.18552E-05	8.76578E-05	0	1	1	0	31392	11408	19984	0	0	0	142
21-27128557-A-G	6.37796E-05	0	0.00010019	2	0	2	31358	11396	19962	0	0	0	442
21-27128574-G-C	3.18654E-05	8.76578E-05	0	1	1	0	31382	11408	19974	0	0	0	38
21-27128583-T-G	3.18431E-05	8.76578E-05	0	1	1	0	31404	11408	19996	0	0	0	8
21-27128612-G-C	3.18613E-05	0	5.0045E-05	1	0	1	31386	11404	19982	0	0	0	113
21-27128641-T-C	6.36902E-05	8.76424E-05	5.002E-05	2	1	1	31402	11410	19992	0	0	0	191
21-27128644-T-C	6.36983E-05	0	0.00010003	2	0	2	31398	11404	19994	0	0	0	195
21-27128646-C-T	3.1957E-05	8.78735E-05	0	1	1	0	31292	11380	19912	0	0	0	156
21-27128659-C-A	0.000414118	0.000526039	0.000350245	13	6	7	31392	11406	19986	0	0	0	304
21-27128663-T-C	3.18492E-05	0	5.002E-05	1	0	1	31398	11406	19992	0	0	0	437
21-27128667-T-C	9.55475E-05	0	0.000150075	3	0	3	31398	11408	19990	0	0	0	57
21-27128674-T-C	3.18573E-05	8.76732E-05	0	1	1	0	31390	11406	19984	0	0	0	229
21-27128674-TCTC-T	6.37146E-05	0	0.00010008	2	0	2	31390	11406	19984	0	0	0	272
21-27128691-C-T	6.37227E-05	8.77039E-05	5.004E-05	2	1	1	31386	11402	19984	0	0	0	395
21-27128696-C-T	3.18735E-05	8.77347E-05	0	1	1	0	31374	11398	19976	0	0	0	127
21-27128697-G-A	6.38121E-05	0.000175654	0	2	2	0	31342	11386	19956	0	0	0	18
21-27128701-C-G	6.37064E-05	0.000175346	0	2	2	0	31394	11406	19988	0	0	0	17
21-27128704-T-A	3.1837E-05	8.76117E-05	0	1	1	0	31410	11414	19996	0	0	0	431
21-27128716-C-A	9.55353E-05	0.000262927	0	3	3	0	31402	11410	19992	0	0	0	351
21-27128725-C-G	3.18431E-05	0	5.002E-05	1	0	1	31404	11412	19992	0	0	0	254
21-27128743-A-G	3.18634E-05	0	5.004E-05	1	0	1	31384	11400	19984	0	0	0	164
21-27128754-T-C	3.1841E-05	0	5.0015E-05	1	0	1	31406	11412	19994	0	0	0	83
21-27128804-A-G	0.000445775	0.001227209	0	14	14	0	31406	11408	19998	0	0	0	300
21-27128809-T-C	3.1839E-05	8.76271E-05	0	1	1	0	31408	11412	19996	0	0	0	108
21-27128828-A-G	6.37146E-05	0.000175346	0	2	2	0	31390	11406	19984	0	0	0	306
21-27128831-C-T	3.1837E-05	8.76271E-05	0	1	1	0	31410	11412	19998	0	0	0	262
21-27128837-G-A	3.18471E-05	8.76732E-05	0	1	1	0	31400	11406	19994	0	0	0	497
21-27128920-C-T	6.36983E-05	0.000175316	0	2	2	0	31398	11408	19990	0	0	0	500
21-27128921-G-A	6.36943E-05	0.000175316	0	2	2	0	31400	11408	19992	0	0	0	226
21-27128934-T-G	3.1835E-05	8.76271E-05	0	1	1	0	31412	11412	20000	0	0	0	104
21-27129076-G-T	6.37389E-05	0.000175562	0	2	2	0	31378	11392	19986	0	0	0	209
21-27129093-G-A	0.321788815	0.113696225	0.440666065	10081	1295	8786	31328	11390	19938	2060	101	1959	250
21-27129121-CTT-C	3.18593E-05	0	5.00551E-05	1	0	1	31388	11410	19978	0	0	0	407
21-27129128-A-G	0.003352062	0.001928809	0.004167085	105	22	83	31324	11406	19918	0	0	0	247
21-27129134-A-T	3.19326E-05	8.77963E-05	0	1	1	0	31316	11390	19926	0	0	0	103
21-27129179-T-C	6.36821E-05	0.000175223	0	2	2	0	31406	11414	19992	0	0	0	85
21-27129180-A-AT	3.1839E-05	0	5.0015E-05	1	0	1	31408	11414	19994	0	0	0	323
21-27129206-A-G	9.55597E-05	0.000175316	5.0035E-05	3	2	1	31394	11408	19986	0	0	0	465
21-27129210-A-T	3.18532E-05	0	5.004E-05	1	0	1	31394	11410	19984	0	0	0	66
21-27129224-A-G	3.18695E-05	0	5.00601E-05	1	0	1	31378	11402	19976	0	0	0	24
21-27129246-A-G	6.37349E-05	0.000175223	0	2	2	0	31380	11414	19966	0	0	0	302
21-27129260-T-A	3.18451E-05	8.75964E-05	0	1	1	0	31402	11416	19986	0	0	0	433
21-27129283-G-A	3.18573E-05	8.76271E-05	0	1	1	0	31390	11412	19978	0	0	0	26
21-27129303-T-C	3.18492E-05	0	5.0035E-05	1	0	1	31398	11412	19986	0	0	0	176
21-27129319-C-A	3.18796E-05	8.76578E-05	0	1	1	0	31368	11408	19960	0	0	0	29
21-27129332-A-G	3.18695E-05	0	5.00851E-05	1	0	1	31378	11412	19966	0	0	0	111
21-27129344-T-A	3.18634E-05	8.76117E-05	0	1	1	0	31384	11414	19970	0	0	0	172
21-27129352-T-G	0.016765475	0.00297932	0.024646829	526	34	492	31374	11412	19962	6	0	6	29
21-27129367-AT-A	3.18959E-05	8.77039E-05	0	1	1	0	31352	11402	19950	0	0	0	430
21-27129368-T-C	0.003027406	0.00833041	0	95	95	0	31380	11404	19976	0	0	0	253
21-27129378-A-G	6.38855E-05	0.000175778	0	2	2	0	31306	11378	19928	0	0	0	463
21-27129385-C-T	6.37714E-05	0.000175439	0	2	2	0	31362	11400	19962	0	0	0	380
21-27129410-T-C	3.18654E-05	0	5.00751E-05	1	0	1	31382	11412	19970	0	0	0	461
21-27129414-A-AT	6.39754E-05	0	0.000100563	2	0	2	31262	11374	19888	0	0	0	310
21-27129425-ACTTTT-A	0.000128924	0	0.000203397	4	0	4	31026	11360	19666	0	0	0	475
21-27129435-T-G	3.18695E-05	8.76578E-05	0	1	1	0	31378	11408	19970	0	0	0	263
21-27129442-G-A	0.022498085	0.061337311	0.000300903	705	699	6	31336	11396	19940	26	26	0	226
21-27129444-A-G	3.19E-05	8.76732E-05	0	1	1	0	31348	11406	19942	0	0	0	468
21-27129459-A-G	0.004843232	0.013236325	5.00601E-05	152	151	1	31384	11408	19976	1	1	0	457
21-27129473-A-G	3.18735E-05	0	5.00751E-05	1	0	1	31374	11404	19970	0	0	0	293
21-27129483-A-G	6.36862E-05	0.000175223	0	2	2	0	31404	11414	19990	0	0	0	254
21-27129512-C-G	0.000318634	0.000876424	0	10	10	0	31384	11410	19974	0	0	0	305
21-27129517-A-C	3.18532E-05	8.76424E-05	0	1	1	0	31394	11410	19984	0	0	0	130
21-27129563-A-G	3.1841E-05	8.76117E-05	0	1	1	0	31406	11414	19992	0	0	0	481
21-27129571-C-T	3.18512E-05	0	5.004E-05	1	0	1	31396	11412	19984	0	0	0	179
21-27129573-G-A	0.023111253	0.063136635	0.00030027	725	719	6	31370	11388	19982	29	29	0	424
21-27129575-T-A	3.1841E-05	0	5.002E-05	1	0	1	31406	11414	19992	0	0	0	44
21-27129579-A-G	0.000222859	0.000613174	0	7	7	0	31410	11416	19994	0	0	0	206
21-27129611-A-AT	0.000159286	0.000438366	0	5	5	0	31390	11406	19984	0	0	0	200
21-27129613-T-A	3.18552E-05	0	5.00551E-05	1	0	1	31392	11414	19978	0	0	0	181
21-27129632-A-G	9.55536E-05	0	0.00015012	3	0	3	31396	11412	19984	0	0	0	319
21-27129633-TTAGG-T	3.18593E-05	0	5.00601E-05	1	0	1	31388	11412	19976	0	0	0	41
21-27129712-G-A	3.19203E-05	0	5.01857E-05	1	0	1	31328	11402	19926	0	0	0	43
21-27129743-A-G	0.032901786	0.072854291	0.000565428	737	730	7	22400	10020	12380	30	30	0	137
21-27129756-ATTTC-A	0.547092836	0.34650053	0.661653376	17031	3921	13110	31130	11316	19814	5058	714	4344	179
21-27129787-G-A	0.000223001	0	0.000350315	7	0	7	31390	11408	19982	0	0	0	227
21-27129788-T-C	9.5584E-05	0.000263112	0	3	3	0	31386	11402	19984	0	0	0	247
21-27129796-G-A	3.18654E-05	0	5.00651E-05	1	0	1	31382	11408	19974	0	0	0	393
21-27129803-C-T	3.18573E-05	0	5.0045E-05	1	0	1	31390	11408	19982	0	0	0	442
21-27129809-T-G	3.18512E-05	0	5.0025E-05	1	0	1	31396	11406	19990	0	0	0	477
21-27129828-G-T	3.18634E-05	8.76732E-05	0	1	1	0	31384	11406	19978	0	0	0	315
21-27129839-G-A	3.18634E-05	8.76885E-05	0	1	1	0	31384	11404	19980	0	0	0	363
21-27129849-G-T	3.18715E-05	0	5.00651E-05	1	0	1	31376	11402	19974	0	0	0	468
21-27129933-C-A	0.000127575	0	0.000200461	4	0	4	31354	11400	19954	0	0	0	217
21-27129942-A-AT	0.000128	0.000351309	0	4	4	0	31250	11386	19864	0	0	0	63
21-27129942-A-G	0.000192	0.000526963	0	6	6	0	31250	11386	19864	0	0	0	426
21-27129953-A-G	9.59386E-05	0.000263435	0	3	3	0	31270	11388	19882	0	0	0	184
21-27129958-A-G	3.1955E-05	0	5.02462E-05	1	0	1	31294	11392	19902	0	0	0	50
21-27129965-ATTT-A	0.000127763	0	0.000200803	4	0	4	31308	11388	19920	0	0	0	167
21-27129975-A-C	3.19366E-05	0	5.01907E-05	1	0	1	31312	11388	19924	0	0	0	353
21-27129983-A-G	3.19366E-05	0	5.01505E-05	1	0	1	31312	11372	19940	0	0	0	464
21-27129995-T-A	3.19061E-05	8.77039E-05	0	1	1	0	31342	11402	19940	0	0	0	120
21-27129996-C-T	0.000127877	0.000351124	0	4	4	0	31280	11392	19888	0	0	0	178
21-27130000-C-A	0.009256895	0.025289779	0.000100301	290	288	2	31328	11388	19940	5	5	0	171
21-27130036-C-T	3.19163E-05	8.77963E-05	0	1	1	0	31332	11390	19942	0	0	0	461
21-27130055-A-G	3.19714E-05	0	5.02462E-05	1	0	1	31278	11376	19902	0	0	0	414
21-27130067-T-C	3.18898E-05	8.77039E-05	0	1	1	0	31358	11402	19956	0	0	0	157
21-27130078-C-T	9.59509E-05	0	0.000150845	3	0	3	31266	11378	19888	0	0	0	265
21-27130080-A-G	3.19734E-05	0	5.02513E-05	1	0	1	31276	11376	19900	0	0	0	180
21-27130150-T-C	3.31961E-05	0	5.23999E-05	1	0	1	30124	11040	19084	0	0	0	25
21-27130160-A-AT	0.018270744	0.046719391	0.000547445	325	319	6	17788	6828	10960	16	16	0	462
21-27130160-A-ATT	0.170508208	0.17589338	0.167153285	3033	1201	1832	17788	6828	10960	149	57	92	351
21-27130160-A-ATTTT	0.015628514	0.036321031	0.002737226	278	248	30	17788	6828	10960	2	2	0	486
21-27130160-AT-A	0.108275242	0.130345636	0.094525547	1926	890	1036	17788	6828	10960	125	72	53	406
21-27130160-ATT-A	0.032493816	0.080404218	0.002645985	578	549	29	17788	6828	10960	46	46	0	6
21-27130160-ATTTTTTT-A	0.008432651	0.009812537	0.007572993	150	67	83	17788	6828	10960	0	0	0	275
21-27130177-TTTTTTTG-T	3.38249E-05	9.081E-05	0	1	1	0	29564	11012	18552	0	0	0	465
21-27130211-A-G	3.58577E-05	0	5.76302E-05	1	0	1	27888	10536	17352	0	0	0	349
21-27130221-A-G	0.000195097	8.88889E-05	0.000256358	6	1	5	30754	11250	19504	0	0	0	459
21-27130222-G-T	0.002012342	0.000274675	0.003016831	60	3	57	29816	10922	18894	0	0	0	430
21-27130236-G-A	3.28106E-05	8.96218E-05	0	1	1	0	30478	11158	19320	0	0	0	195
21-27130258-T-TAA	0.000128263	0.000352485	0	4	4	0	31186	11348	19838	0	0	0	84
21-27130312-T-C	3.18837E-05	8.77347E-05	0	1	1	0	31364	11398	19966	0	0	0	290
21-27130322-T-C	3.18674E-05	8.76885E-05	0	1	1	0	31380	11404	19976	0	0	0	415
21-27130359-G-A	3.19816E-05	0	5.02765E-05	1	0	1	31268	11378	19890	0	0	0	48
21-27130370-A-C	3.1955E-05	8.78426E-05	0	1	1	0	31294	11384	19910	0	0	0	344
21-27130383-A-C	3.19346E-05	0	5.01706E-05	1	0	1	31314	11382	19932	0	0	0	210
21-27130392-G-A	6.39468E-05	0	0.000100513	2	0	2	31276	11378	19898	0	0	0	375
21-27130430-A-G	3.19081E-05	8.77501E-05	0	1	1	0	31340	11396	19944	0	0	0	293
21-27130442-C-G	6.38244E-05	0	0.000100311	2	0	2	31336	11398	19938	0	0	0	36
21-27130458-TTTCAGCGGG-T	3.18817E-05	8.77193E-05	0	1	1	0	31366	11400	19966	0	0	0	313
21-27130482-A-T	3.18878E-05	0	5.00851E-05	1	0	1	31360	11394	19966	0	0	0	200
21-27130490-G-C	3.1902E-05	8.77963E-05	0	1	1	0	31346	11390	19956	0	0	0	183
21-27130533-T-C	9.55597E-05	0.000262973	0	3	3	0	31394	11408	19986	0	0	0	338
21-27130545-G-A	0.000318756	0	0.000500801	10	0	10	31372	11404	19968	0	0	0	98
21-27130547-A-G	3.18613E-05	8.77039E-05	0	1	1	0	31386	11402	19984	0	0	0	145
21-27130575-A-G	3.18512E-05	0	5.004E-05	1	0	1	31396	11412	19984	0	0	0	500
21-27130592-GTTGT-G	3.18573E-05	8.76885E-05	0	1	1	0	31390	11404	19986	0	0	0	270
21-27130598-T-C	0.003885103	0.002191445	0.004851455	122	25	97	31402	11408	19994	0	0	0	237
21-27130614-TAATAAGC-T	3.1839E-05	0	5.001E-05	1	0	1	31408	11412	19996	0	0	0	100
21-27130616-AT-A	3.1839E-05	8.76424E-05	0	1	1	0	31408	11410	19998	0	0	0	478
21-27130617-TAAGC-T	3.18471E-05	0	5.0015E-05	1	0	1	31400	11406	19994	0	0	0	298
21-27130634-CATTT-C	3.18593E-05	0	5.004E-05	1	0	1	31388	11404	19984	0	0	0	395
21-27130644-C-T	6.37064E-05	0.000175346	0	2	2	0	31394	11406	19988	0	0	0	203
21-27130648-A-G	3.18431E-05	8.76424E-05	0	1	1	0	31404	11410	19994	0	0	0	191
21-27130664-A-G	9.55597E-05	0	0.000150075	3	0	3	31394	11404	19990	0	0	0	247
21-27130750-C-G	3.18674E-05	0	5.00751E-05	1	0	1	31380	11410	19970	0	0	0	55
21-27130759-G-T	6.37105E-05	0	0.00010008	2	0	2	31392	11408	19984	0	0	0	364
21-27130764-A-T	6.36821E-05	0	0.00010003	2	0	2	31406	11412	19994	0	0	0	242
21-27130782-C-T	3.18593E-05	8.77039E-05	0	1	1	0	31388	11402	19986	0	0	0	379
21-27130809-G-C	3.18695E-05	0	5.0035E-05	1	0	1	31378	11392	19986	0	0	0	435
21-27130825-A-G	3.18471E-05	8.76732E-05	0	1	1	0	31400	11406	19994	0	0	0	39
21-27130831-T-C	0.000191083	0.000525855	0	6	6	0	31400	11410	19990	0	0	0	404
21-27130832-G-A	3.18552E-05	8.76578E-05	0	1	1	0	31392	11408	19984	0	0	0	314
21-27130838-C-T	3.18492E-05	8.77039E-05	0	1	1	0	31398	11402	19996	0	0	0	414
21-27130844-ACTTAGCCCT-A	3.18431E-05	0	5.0015E-05	1	0	1	31404	11410	19994	0	0	0	61
21-27130891-C-T	3.18431E-05	8.76578E-05	0	1	1	0	31404	11408	19996	0	0	0	83
21-27130895-T-TA	6.36943E-05	0.000175346	0	2	2	0	31400	11406	19994	0	0	0	391
21-27130902-A-G	3.18512E-05	0	5.0025E-05	1	0	1	31396	11406	19990	0	0	0	12
21-27130909-A-G	0.000413907	8.76424E-05	0.00060006	13	1	12	31408	11410	19998	0	0	0	208
21-27130918-C-T	3.18492E-05	8.76271E-05	0	1	1	0	31398	11412	19986	0	0	0	250
21-27130926-A-G	3.1841E-05	8.76271E-05	0	1	1	0	31406	11412	19994	0	0	0	365
21-27130927-T-A	3.18492E-05	8.76885E-05	0	1	1	0	31398	11404	19994	0	0	0	309
21-27130929-A-G	0.01471525	0.039891285	0.000350175	462	455	7	31396	11406	19990	14	14	0	497
21-27130939-A-G	3.1837E-05	8.76271E-05	0	1	1	0	31410	11412	19998	0	0	0	22
21-27130944-G-C	3.18471E-05	0	5.0025E-05	1	0	1	31400	11410	19990	0	0	0	203
21-27130946-T-G	3.18431E-05	0	5.0005E-05	1	0	1	31404	11406	19998	0	0	0	170
21-27130983-C-T	9.55292E-05	0	0.00015006	3	0	3	31404	11412	19992	0	0	0	150
21-27131020-T-A	3.18471E-05	8.76732E-05	0	1	1	0	31400	11406	19994	0	0	0	124
21-27131028-A-G	3.18471E-05	8.76424E-05	0	1	1	0	31400	11410	19990	0	0	0	243
21-27131030-G-A	6.36943E-05	0.000175285	0	2	2	0	31400	11410	19990	0	0	0	395
21-27131055-C-T	6.37105E-05	0.000175346	0	2	2	0	31392	11406	19986	0	0	0	14
21-27131073-A-T	0.000159276	0	0.000250225	5	0	5	31392	11410	19982	0	0	0	142
21-27131078-T-A	0.000318654	0.000876578	0	10	10	0	31382	11408	19974	0	0	0	91
21-27131090-T-C	3.1839E-05	0	5.001E-05	1	0	1	31408	11412	19996	0	0	0	412
21-27131116-A-T	3.18451E-05	0	5.002E-05	1	0	1	31402	11410	19992	0	0	0	15
21-27131128-C-T	3.18492E-05	0	5.0025E-05	1	0	1	31398	11408	19990	0	0	0	62
21-27131130-A-G	0.023058794	0.062960365	0.00030009	724	718	6	31398	11404	19994	28	28	0	448
21-27131161-A-T	0.000127421	0.000350754	0	4	4	0	31392	11404	19988	0	0	0	212
21-27131179-G-A	9.5645E-05	8.77655E-05	0.00010014	3	1	2	31366	11394	19972	0	0	0	199
21-27131197-G-A	3.18837E-05	0	5.00701E-05	1	0	1	31364	11392	19972	0	0	0	419
21-27131222-A-T	3.18654E-05	8.77039E-05	0	1	1	0	31382	11402	19980	0	0	0	137
21-27131226-C-T	3.19591E-05	0	5.02311E-05	1	0	1	31290	11382	19908	0	0	0	396
21-27131236-G-A	3.18918E-05	8.77963E-05	0	1	1	0	31356	11390	19966	0	0	0	292
21-27131238-G-A	0.000191351	0.000439136	5.00751E-05	6	5	1	31356	11386	19970	0	0	0	389
21-27131243-AGGT-A	3.18796E-05	8.77039E-05	0	1	1	0	31368	11402	19966	0	0	0	216
21-27131251-C-T	6.37227E-05	0.000175408	0	2	2	0	31386	11402	19984	0	0	0	417
21-27131271-CTT-C	3.18613E-05	0	5.00601E-05	1	0	1	31386	11410	19976	0	0	0	93
21-27131287-G-A	6.37146E-05	0.000175377	0	2	2	0	31390	11404	19986	0	0	0	450
21-27131295-A-G	3.18613E-05	8.76578E-05	0	1	1	0	31386	11408	19978	0	0	0	53
21-27131306-G-A	6.37146E-05	0	0.00010005	2	0	2	31390	11400	19990	0	0	0	32
21-27131313-G-A	3.18471E-05	8.76578E-05	0	1	1	0	31400	11408	19992	0	0	0	447
21-27131340-C-T	0.017654557	0.007981056	0.023175493	554	91	463	31380	11402	19978	10	2	8	50
21-27131345-C-T	3.18451E-05	8.76271E-05	0	1	1	0	31402	11412	19990	0	0	0	3
21-27131368-A-G	0.000637064	0.001754694	0	20	20	0	31394	11398	19996	0	0	0	117
21-27131375-C-G	3.2684E-05	8.93495E-05	0	1	1	0	30596	11192	19404	0	0	0	162
21-27131377-A-G	6.37633E-05	0.000175778	0	2	2	0	31366	11378	19988	0	0	0	389
21-27131385-AAAAAG-A	0.000191253	0.000527426	0	6	6	0	31372	11376	19996	0	0	0	403
21-27131386-AAAAG-A	3.18735E-05	8.78889E-05	0	1	1	0	31374	11378	19996	0	0	0	181
21-27131388-AAG-A	0.001051491	0.002808496	5.0025E-05	33	32	1	31384	11394	19990	0	0	0	62
21-27131388-AAGAG-A	0.009208514	0.025188696	0.00010005	289	287	2	31384	11394	19990	4	4	0	185
21-27131389-A-AT	3.18756E-05	0	5.0045E-05	1	0	1	31372	11390	19982	0	0	0	244
21-27131391-AG-A	9.5816E-05	0.000264971	0	3	3	0	31310	11322	19988	0	0	0	88
21-27131393-AGAG-A	9.7352E-05	0.000276906	0	3	3	0	30816	10834	19982	0	0	0	419
21-27131413-C-T	6.37146E-05	8.77193E-05	5.0025E-05	2	1	1	31390	11400	19990	0	0	0	229
21-27131422-C-A	3.18695E-05	8.78272E-05	0	1	1	0	31378	11386	19992	0	0	0	469
21-27131427-A-G	3.18471E-05	0	5.0015E-05	1	0	1	31400	11406	19994	0	0	0	317
21-27131451-T-G	3.18552E-05	8.77347E-05	0	1	1	0	31392	11398	19994	0	0	0	287
21-27131458-T-C	3.18552E-05	8.77501E-05	0	1	1	0	31392	11396	19996	0	0	0	11
21-27131470-C-T	3.18552E-05	0	5.001E-05	1	0	1	31392	11396	19996	0	0	0	459
21-27131501-C-T	6.36902E-05	8.76732E-05	5.001E-05	2	1	1	31402	11406	19996	0	0	0	215
21-27131502-G-A	3.18532E-05	8.76885E-05	0	1	1	0	31394	11404	19990	0	0	0	261
21-27131510-C-T	6.36983E-05	0.000175346	0	2	2	0	31398	11406	19992	0	0	0	166
21-27131520-G-C	3.18451E-05	0	5.0015E-05	1	0	1	31402	11408	19994	0	0	0	249
21-27131547-C-A	3.1839E-05	0	5.0005E-05	1	0	1	31408	11410	19998	0	0	0	264
21-27131553-C-A	0.000413986	0.000350631	0.000450135	13	4	9	31402	11408	19994	0	0	0	437
21-27131585-T-C	3.1841E-05	8.76424E-05	0	1	1	0	31406	11410	19996	0	0	0	376
21-27131587-C-T	3.1837E-05	0	5.0005E-05	1	0	1	31410	11412	19998	0	0	0	28
21-27131603-G-T	3.18451E-05	0	5.002E-05	1	0	1	31402	11410	19992	0	0	0	327
21-27131614-G-A	3.18471E-05	8.76732E-05	0	1	1	0	31400	11406	19994	0	0	0	272
21-27131653-A-G	0.023163194	0.063245614	0.00030021	727	721	6	31386	11400	19986	29	29	0	236
21-27131654-C-T	3.18634E-05	0	5.0045E-05	1	0	1	31384	11402	19982	0	0	0	161
21-27131658-A-G	3.18593E-05	0	5.0035E-05	1	0	1	31388	11402	19986	0	0	0	23
21-27131671-T-C	3.18634E-05	0	5.004E-05	1	0	1	31384	11400	19984	0	0	0	38
21-27131677-G-A	3.18593E-05	8.77347E-05	0	1	1	0	31388	11398	19990	0	0	0	272
21-27131681-G-A	3.18674E-05	0	5.0035E-05	1	0	1	31380	11394	19986	0	0	0	337
21-27131685-T-G	3.18715E-05	0	5.00651E-05	1	0	1	31376	11402	19974	0	0	0	478
21-27131692-C-G	6.37389E-05	8.77809E-05	5.0035E-05	2	1	1	31378	11392	19986	0	0	0	441
21-27131702-A-G	9.56023E-05	0.0001755	5.004E-05	3	2	1	31380	11396	19984	0	0	0	414
21-27131703-T-G	3.18593E-05	0	5.004E-05	1	0	1	31388	11404	19984	0	0	0	333
21-27131742-T-G	3.18613E-05	8.77347E-05	0	1	1	0	31386	11398	19988	0	0	0	286
21-27131766-C-G	0.022042428	0.060252587	0.0002501	692	687	5	31394	11402	19992	26	26	0	451
21-27131780-T-C	0.000701486	0.001931858	0	22	22	0	31362	11388	19974	0	0	0	18
21-27131806-G-A	9.55901E-05	0.000263112	0	3	3	0	31384	11402	19982	0	0	0	34
21-27131827-C-T	6.37146E-05	8.76578E-05	5.0045E-05	2	1	1	31390	11408	19982	0	0	0	329
21-27131832-G-T	3.18756E-05	0	5.00701E-05	1	0	1	31372	11400	19972	0	0	0	61
21-27131835-GA-G	9.56267E-05	0	0.000150195	3	0	3	31372	11398	19974	0	0	0	39
21-27131864-T-G	9.55718E-05	0.000263066	0	3	3	0	31390	11404	19986	0	0	0	218
21-27131880-A-G	3.18878E-05	0	5.00651E-05	1	0	1	31360	11386	19974	0	0	0	19
21-27131886-A-G	0.023144606	0.063191153	0.000300391	726	720	6	31368	11394	19974	29	29	0	101
21-27131892-G-A	3.18939E-05	8.77809E-05	0	1	1	0	31354	11392	19962	0	0	0	185
21-27131903-C-G	6.37511E-05	0.000175531	0	2	2	0	31372	11394	19978	0	0	0	266
21-27131908-A-G	3.18613E-05	8.77501E-05	0	1	1	0	31386	11396	19990	0	0	0	450
21-27131910-G-GT	0.000127551	0.000175593	0.00010015	4	2	2	31360	11390	19970	0	0	0	152
21-27131927-A-G	0.023103888	0.063059112	0.00030033	725	719	6	31380	11402	19978	29	29	0	196
21-27131930-A-T	0.000127421	0	0.00020016	4	0	4	31392	11408	19984	0	0	0	250
21-27131947-A-G	3.18573E-05	8.77347E-05	0	1	1	0	31390	11398	19992	0	0	0	424
21-27131978-A-G	3.18512E-05	0	5.0035E-05	1	0	1	31396	11410	19986	0	0	0	134
21-27131989-T-TA	3.18431E-05	0	5.001E-05	1	0	1	31404	11408	19996	0	0	0	410
21-27132003-G-A	3.18471E-05	8.76424E-05	0	1	1	0	31400	11410	19990	0	0	0	299
21-27132031-T-G	3.18471E-05	8.76578E-05	0	1	1	0	31400	11408	19992	0	0	0	131
21-27132037-TC-T	0.001178269	0.002891186	0.00020012	37	33	4	31402	11414	19988	0	0	0	319
21-27132041-A-G	3.1841E-05	0	5.0015E-05	1	0	1	31406	11412	19994	0	0	0	37
21-27132051-C-T	6.37511E-05	0	0.00010006	2	0	2	31372	11384	19988	0	0	0	288
21-27132103-G-A	3.18634E-05	8.76732E-05	0	1	1	0	31384	11406	19978	0	0	0	108
21-27132105-G-A	3.18593E-05	0	5.0045E-05	1	0	1	31388	11406	19982	0	0	0	263
21-27132108-A-T	9.55536E-05	0	0.000150105	3	0	3	31396	11410	19986	0	0	0	248
21-27132111-T-C	3.18492E-05	0	5.0035E-05	1	0	1	31398	11412	19986	0	0	0	36
21-27132117-G-C	3.18512E-05	8.76117E-05	0	1	1	0	31396	11414	19982	0	0	0	11
21-27132131-T-C	3.18532E-05	8.76732E-05	0	1	1	0	31394	11406	19988	0	0	0	35
21-27132171-G-T	0.000382239	0.001051893	0	12	12	0	31394	11408	19986	0	0	0	60
21-27132176-T-G	3.18471E-05	8.76732E-05	0	1	1	0	31400	11406	19994	0	0	0	283
21-27132177-T-A	3.18512E-05	8.76732E-05	0	1	1	0	31396	11406	19990	0	0	0	484
21-27132196-G-GT	3.18715E-05	8.77193E-05	0	1	1	0	31376	11400	19976	0	0	0	442
21-27132211-TCCCA-T	3.18492E-05	8.76578E-05	0	1	1	0	31398	11408	19990	0	0	0	28
21-27132215-A-ATT	3.18512E-05	8.76424E-05	0	1	1	0	31396	11410	19986	0	0	0	279
21-27132219-C-T	3.18573E-05	8.76732E-05	0	1	1	0	31390	11406	19984	0	0	0	281
21-27132253-C-G	0.001050888	0.000525855	0.00135054	33	6	27	31402	11410	19992	0	0	0	428
21-27132272-T-C	3.18451E-05	8.76424E-05	0	1	1	0	31402	11410	19992	0	0	0	381
21-27132284-A-G	0.004490732	0.001489921	0.006203722	141	17	124	31398	11410	19988	0	0	0	216
21-27132317-CTT-C	3.18471E-05	8.76578E-05	0	1	1	0	31400	11408	19992	0	0	0	83
21-27132324-A-G	3.18471E-05	8.76578E-05	0	1	1	0	31400	11408	19992	0	0	0	204
21-27132340-G-A	0.003504971	0.001491228	0.004653723	110	17	93	31384	11400	19984	0	0	0	443
21-27132376-T-C	3.18471E-05	0	5.0005E-05	1	0	1	31400	11402	19998	0	0	0	145
21-27132406-A-G	3.18573E-05	8.77039E-05	0	1	1	0	31390	11402	19988	0	0	0	500
21-27132409-G-C	3.18532E-05	8.76271E-05	0	1	1	0	31394	11412	19982	0	0	0	80
21-27132435-C-T	9.55414E-05	0.000175285	5.0025E-05	3	2	1	31400	11410	19990	0	0	0	185
21-27132474-C-T	3.1839E-05	8.76271E-05	0	1	1	0	31408	11412	19996	0	0	0	58
21-27132476-G-A	3.1841E-05	8.76424E-05	0	1	1	0	31406	11410	19996	0	0	0	205
21-27132521-A-G	6.36699E-05	0	0.00010001	2	0	2	31412	11414	19998	0	0	0	493
21-27132525-T-C	0.011718252	0.032077125	0.00010003	368	366	2	31404	11410	19994	10	10	0	245
21-27132527-G-A	3.18471E-05	0	5.0025E-05	1	0	1	31400	11410	19990	0	0	0	327
21-27132533-TG-T	3.18451E-05	8.76424E-05	0	1	1	0	31402	11410	19992	0	0	0	18
21-27132548-G-A	3.18552E-05	8.76732E-05	0	1	1	0	31392	11406	19986	0	0	0	170
21-27132566-G-A	0.000159256	0	0.0002501	5	0	5	31396	11404	19992	0	0	0	435
21-27132586-TCTTA-T	0.005126735	0.000526039	0.007750775	161	6	155	31404	11406	19998	1	0	1	277
21-27132601-T-C	0.277653596	0.455659379	0.176547166	8695	5169	3526	31316	11344	19972	1552	1243	309	302
21-27132631-C-T	6.37186E-05	8.77039E-05	5.0035E-05	2	1	1	31388	11402	19986	0	0	0	490
21-27132641-T-G	3.18613E-05	0	5.0045E-05	1	0	1	31386	11404	19982	0	0	0	162
21-27132658-T-C	3.1839E-05	0	5.001E-05	1	0	1	31408	11412	19996	0	0	0	195
21-27132692-C-T	3.18471E-05	0	5.002E-05	1	0	1	31400	11408	19992	0	0	0	269
21-27132694-G-A	0.022960321	0.062751972	0.0002501	721	716	5	31402	11410	19992	28	28	0	45
21-27132699-G-A	3.18451E-05	0	5.002E-05	1	0	1	31402	11410	19992	0	0	0	109
21-27132700-T-C	0.000286588	0.00035057	0.000250075	9	4	5	31404	11410	19994	0	0	0	496
21-27132711-G-A	0.000350274	0.000875964	5.003E-05	11	10	1	31404	11416	19988	0	0	0	276
21-27132740-C-T	6.37267E-05	0.000175408	0	2	2	0	31384	11402	19982	0	0	0	233
21-27132780-G-T	3.18613E-05	0	5.0035E-05	1	0	1	31386	11400	19986	0	0	0	373
21-27132788-T-C	0.001211348	0.003161778	0.00010008	38	36	2	31370	11386	19984	0	0	0	396
21-27132803-C-T	3.18776E-05	0	5.0035E-05	1	0	1	31370	11384	19986	0	0	0	324
21-27132805-G-A	0.004847248	0.013268893	5.00551E-05	152	151	1	31358	11380	19978	1	1	0	387
21-27132821-G-A	3.18837E-05	8.78735E-05	0	1	1	0	31364	11380	19984	0	0	0	32
21-27132825-T-TCCC	3.19387E-05	8.81368E-05	0	1	1	0	31310	11346	19964	0	0	0	19
21-27132825-TC-T	3.19387E-05	0	5.00902E-05	1	0	1	31310	11346	19964	0	0	0	292
21-27132826-C-A	6.38121E-05	8.79507E-05	5.00701E-05	2	1	1	31342	11370	19972	0	0	0	138
21-27132830-C-A	3.18979E-05	8.79044E-05	0	1	1	0	31350	11376	19974	0	0	0	334
21-27132830-C-G	3.18979E-05	8.79044E-05	0	1	1	0	31350	11376	19974	0	0	0	72
21-27132831-C-T	6.37714E-05	0.000175747	0	2	2	0	31362	11380	19982	0	0	0	356
21-27132833-A-G	9.57426E-05	0.000263899	0	3	3	0	31334	11368	19966	0	0	0	265
21-27132875-A-G	3.18837E-05	8.78889E-05	0	1	1	0	31364	11378	19986	0	0	0	73
21-27132954-T-G	1	1	1	31374	11394	19980	31374	11394	19980	15687	5697	9990	471
21-27132964-A-G	3.18735E-05	8.77655E-05	0	1	1	0	31374	11394	19980	0	0	0	179
21-27132972-A-G	0.000478347	0.000175469	0.000651303	15	2	13	31358	11398	19960	0	0	0	121
21-27132983-T-G	6.37267E-05	8.77501E-05	5.003E-05	2	1	1	31384	11396	19988	0	0	0	395
21-27132992-A-G	0.004620483	0.012633795	5.004E-05	145	144	1	31382	11398	19984	2	2	0	214
21-27132999-T-C	3.18674E-05	0	5.0045E-05	1	0	1	31380	11398	19982	0	0	0	46
21-27133005-T-C	3.18776E-05	0	5.00601E-05	1	0	1	31370	11394	19976	0	0	0	14
21-27133050-C-T	3.18471E-05	0	5.003E-05	1	0	1	31400	11412	19988	0	0	0	47
21-27133081-G-A	3.18471E-05	0	5.004E-05	1	0	1	31400	11416	19984	0	0	0	150
21-27133082-T-A	0.000223001	0.000263019	0.00020016	7	3	4	31390	11406	19984	0	0	0	113
21-27133107-AG-A	0.001498533	0.004124978	0	47	47	0	31364	11394	19970	0	0	0	336
21-27133120-A-G	3.18756E-05	0	5.00601E-05	1	0	1	31372	11396	19976	0	0	0	475
21-27133121-T-A	3.18532E-05	0	5.003E-05	1	0	1	31394	11406	19988	0	0	0	493
21-27133148-A-G	3.19754E-05	0	5.0221E-05	1	0	1	31274	11362	19912	0	0	0	497
21-27133161-C-G	6.40246E-05	0.000176491	0	2	2	0	31238	11332	19906	0	0	0	323
21-27133168-TC-T	6.42302E-05	0	0.000100644	2	0	2	31138	11266	19872	0	0	0	254
21-27133171-A-G	9.63886E-05	0	0.000150845	3	0	3	31124	11236	19888	0	0	0	469
21-27133175-C-CG	3.49528E-05	9.27816E-05	0	1	1	0	28610	10778	17832	0	0	0	23
21-27133175-C-CT	0.086997553	0.109760623	0.073239121	2489	1183	1306	28610	10778	17832	98	63	35	259
21-27133186-T-C	0.000191902	0.000175963	0.000201005	6	2	4	31266	11366	19900	0	0	0	424
21-27133186-T-TC	0.001567198	0.004047158	0.000150754	49	46	3	31266	11366	19900	0	0	0	112
21-27133192-T-G	3.19611E-05	0	5.02008E-05	1	0	1	31288	11368	19920	0	0	0	167
21-27133194-T-G	3.19122E-05	8.77963E-05	0	1	1	0	31336	11390	19946	0	0	0	399
21-27133247-A-G	0.000223414	0	0.000351053	7	0	7	31332	11392	19940	0	0	0	165
21-27133249-A-C	9.56816E-05	0.000175562	5.00952E-05	3	2	1	31354	11392	19962	0	0	0	55
21-27133290-G-A	3.18532E-05	0	5.0035E-05	1	0	1	31394	11408	19986	0	0	0	256
21-27133290-G-C	3.18532E-05	0	5.0035E-05	1	0	1	31394	11408	19986	0	0	0	145
21-27133291-T-A	3.18431E-05	0	5.002E-05	1	0	1	31404	11412	19992	0	0	0	298
21-27133313-C-T	3.18756E-05	8.77501E-05	0	1	1	0	31372	11396	19976	0	0	0	14
21-27133327-G-A	0.000159378	0	0.0002503	5	0	5	31372	11396	19976	0	0	0	107
21-27133328-A-C	0.000159418	0	0.000250376	5	0	5	31364	11394	19970	0	0	0	342
21-27133342-T-C	3.18695E-05	8.77501E-05	0	1	1	0	31378	11396	19982	0	0	0	61
21-27133350-A-G	3.18776E-05	8.77501E-05	0	1	1	0	31370	11396	19974	0	0	0	248
21-27133356-TC-T	3.18878E-05	8.77501E-05	0	1	1	0	31360	11396	19964	0	0	0	158
21-27133357-C-T	3.19101E-05	0	5.01153E-05	1	0	1	31338	11384	19954	0	0	0	491
21-27133375-A-G	0.000478194	0.000351124	0.000550661	15	4	11	31368	11392	19976	0	0	0	475
21-27133391-A-G	3.18552E-05	8.76885E-05	0	1	1	0	31392	11404	19988	0	0	0	385
21-27133414-G-A	6.37471E-05	0.000175408	0	2	2	0	31374	11402	19972	0	0	0	59
21-27133416-A-AT	0.000127861	0.000175778	0.000100472	4	2	2	31284	11378	19906	0	0	0	165
21-27133429-A-G	6.38407E-05	0.000175531	0	2	2	0	31328	11394	19934	0	0	0	467
21-27133438-A-G	9.56084E-05	0.000263204	0	3	3	0	31378	11398	19980	0	0	0	110
21-27133462-A-C	3.18654E-05	8.77501E-05	0	1	1	0	31382	11396	19986	0	0	0	392
21-27133482-CAGTG-C	3.18593E-05	0	5.004E-05	1	0	1	31388	11404	19984	0	0	0	492
21-27133491-T-G	3.18451E-05	0	5.0025E-05	1	0	1	31402	11412	19990	0	0	0	353
21-27133498-T-C	3.18492E-05	8.76885E-05	0	1	1	0	31398	11404	19994	0	0	0	153
21-27133514-T-C	0.000318492	0.00078892	5.0025E-05	10	9	1	31398	11408	19990	0	0	0	54
21-27133530-C-G	9.56206E-05	0	0.00015018	3	0	3	31374	11398	19976	0	0	0	229
21-27133541-CAT-C	3.18837E-05	0	5.00851E-05	1	0	1	31364	11398	19966	0	0	0	285
21-27133555-C-A	3.18695E-05	8.77655E-05	0	1	1	0	31378	11394	19984	0	0	0	100
21-27133558-C-G	6.37267E-05	8.77039E-05	5.0045E-05	2	1	1	31384	11402	19982	0	0	0	57
21-27133567-C-T	3.18471E-05	0	5.001E-05	1	0	1	31400	11404	19996	0	0	0	183
21-27133569-CATG-C	3.18532E-05	0	5.0015E-05	1	0	1	31394	11400	19994	0	0	0	485
21-27133570-A-G	6.36821E-05	0	0.00010001	2	0	2	31406	11408	19998	0	0	0	181
21-27133594-A-G	9.55353E-05	0	0.000150045	3	0	3	31402	11408	19994	0	0	0	321
21-27133620-G-A	9.55414E-05	0.000263019	0	3	3	0	31400	11406	19994	0	0	0	211
21-27133630-G-A	3.18471E-05	8.76424E-05	0	1	1	0	31400	11410	19990	0	0	0	252
21-27133639-AC-A	3.18471E-05	0	5.003E-05	1	0	1	31400	11412	19988	0	0	0	451
21-27133659-A-C	0.000191046	0	0.00030012	6	0	6	31406	11414	19992	0	0	0	166
21-27133659-A-T	3.1841E-05	0	5.002E-05	1	0	1	31406	11414	19992	0	0	0	191
21-27133662-A-C	3.1841E-05	8.76117E-05	0	1	1	0	31406	11414	19992	0	0	0	469
21-27133673-A-C	3.18471E-05	0	5.0015E-05	1	0	1	31400	11406	19994	0	0	0	287
21-27133683-C-A	3.18471E-05	0	5.0025E-05	1	0	1	31400	11410	19990	0	0	0	67
21-27133713-A-T	3.18634E-05	8.77039E-05	0	1	1	0	31384	11402	19982	0	0	0	226
21-27133743-C-T	3.18431E-05	8.76424E-05	0	1	1	0	31404	11410	19994	0	0	0	174
21-27133745-T-C	0.001210191	0.003155127	0.00010005	38	36	2	31400	11410	19990	0	0	0	223
21-27133766-T-G	6.3743E-05	0.000175716	0	2	2	0	31376	11382	19994	0	0	0	384
21-27133781-CT-C	0.011496815	0.031452602	0.00010007	361	359	2	31400	11414	19986	9	9	0	178
21-27133796-G-A	3.18593E-05	0	5.00501E-05	1	0	1	31388	11408	19980	0	0	0	285
21-27133797-T-G	3.18471E-05	0	5.0025E-05	1	0	1	31400	11410	19990	0	0	0	453
21-27133804-A-T	3.18654E-05	0	5.00551E-05	1	0	1	31382	11404	19978	0	0	0	421
21-27133805-A-G	0.001688866	0.004645048	0	53	53	0	31382	11410	19972	0	0	0	125
21-27133821-G-T	3.18471E-05	0	5.003E-05	1	0	1	31400	11412	19988	0	0	0	384
21-27133822-C-T	3.18552E-05	0	5.004E-05	1	0	1	31392	11408	19984	0	0	0	216
21-27133826-C-A	0.000860147	0.001928809	0.0002502	27	22	5	31390	11406	19984	0	0	0	335
21-27133826-C-T	3.18573E-05	8.76732E-05	0	1	1	0	31390	11406	19984	0	0	0	177
21-27133841-T-A	3.18532E-05	0	5.0035E-05	1	0	1	31394	11408	19986	0	0	0	347
21-27133858-A-G	6.36862E-05	0.000175223	0	2	2	0	31404	11414	19990	0	0	0	69
21-27133870-G-A	0.000350363	0.000876271	5.004E-05	11	10	1	31396	11412	19984	0	0	0	33
21-27133874-G-T	3.18492E-05	0	5.0025E-05	1	0	1	31398	11408	19990	0	0	0	33
21-27133880-G-A	3.18471E-05	0	5.0035E-05	1	0	1	31400	11414	19986	0	0	0	474
21-27133880-G-T	3.18471E-05	8.76117E-05	0	1	1	0	31400	11414	19986	0	0	0	382
21-27133902-G-A	3.1839E-05	0	5.002E-05	1	0	1	31408	11416	19992	0	0	0	120
21-27133918-G-T	0.000382141	0	0.00060024	12	0	12	31402	11410	19992	0	0	0	496
21-27133937-C-G	0.000350363	0.000263066	0.00040016	11	3	8	31396	11404	19992	0	0	0	223
21-27133955-G-A	3.1841E-05	0	5.001E-05	1	0	1	31406	11410	19996	0	0	0	425
21-27133965-T-A	0.006688324	0.01806067	0.00020008	210	206	4	31398	11406	19992	3	3	0	450
21-27133977-G-T	3.18492E-05	0	5.0025E-05	1	0	1	31398	11408	19990	0	0	0	428
21-27134041-A-G	3.18492E-05	8.76117E-05	0	1	1	0	31398	11414	19984	0	0	0	64
21-27134051-C-T	3.18532E-05	8.76732E-05	0	1	1	0	31394	11406	19988	0	0	0	182
21-27134078-A-G	3.18471E-05	0	5.002E-05	1	0	1	31400	11408	19992	0	0	0	414
21-27134117-T-C	0.001432847	0.000613389	0.00190057	45	7	38	31406	11412	19994	1	0	1	268
21-27134151-G-C	3.18512E-05	8.76424E-05	0	1	1	0	31396	11410	19986	0	0	0	164
21-27134179-A-G	3.18451E-05	8.76578E-05	0	1	1	0	31402	11408	19994	0	0	0	325
21-27134194-A-G	3.18471E-05	0	5.0025E-05	1	0	1	31400	11410	19990	0	0	0	438
21-27134223-G-A	0.000350475	8.77347E-05	0.0005003	11	1	10	31386	11398	19988	0	0	0	73
21-27134246-G-A	9.56328E-05	0.000263158	0	3	3	0	31370	11400	19970	0	0	0	203
21-27134246-G-T	6.37552E-05	0.000175439	0	2	2	0	31370	11400	19970	0	0	0	264
21-27134258-T-C	3.18776E-05	8.77501E-05	0	1	1	0	31370	11396	19974	0	0	0	121
21-27134268-G-T	0.000286935	0.000789474	0	9	9	0	31366	11400	19966	0	0	0	376
21-27134272-A-G	3.18735E-05	0	5.00701E-05	1	0	1	31374	11402	19972	0	0	0	447
21-27134283-T-C	3.18674E-05	0	5.00601E-05	1	0	1	31380	11404	19976	0	0	0	485
21-27134306-A-G	3.18613E-05	0	5.00551E-05	1	0	1	31386	11408	19978	0	0	0	490
21-27134310-T-A	3.18552E-05	0	5.0045E-05	1	0	1	31392	11410	19982	0	0	0	347
21-27134316-A-G	3.18613E-05	8.76885E-05	0	1	1	0	31386	11404	19982	0	0	0	419
21-27134336-A-G	0.00455327	0.01182758	0.00040016	143	135	8	31406	11414	19992	3	3	0	173
21-27134341-A-G	6.37105E-05	0.000175285	0	2	2	0	31392	11410	19982	0	0	0	490
21-27134345-T-TGGA	9.55414E-05	0.000262835	0	3	3	0	31400	11414	19986	0	0	0	188
21-27134346-T-TTTCAATACAATACAAGATCTGATCTTGAAGATTTCCATATTTTTACATGGCTTTATGTGAATTTCAATACAATTCAATACAAATTTCAATACAATTTCAATACAA	9.55475E-05	0.000262927	0	3	3	0	31398	11410	19988	0	0	0	189
21-27134355-G-A	3.18776E-05	8.77039E-05	0	1	1	0	31370	11402	19968	0	0	0	60
21-27134360-C-T	6.37511E-05	0.000175439	0	2	2	0	31372	11400	19972	0	0	0	482
21-27134362-A-G	3.18552E-05	0	5.004E-05	1	0	1	31392	11408	19984	0	0	0	273
21-27134381-T-C	3.18512E-05	8.76424E-05	0	1	1	0	31396	11410	19986	0	0	0	200
21-27134403-G-A	0.000287026	0.000263296	0.000300571	9	3	6	31356	11394	19962	0	0	0	487
21-27134406-C-G	3.1902E-05	8.77193E-05	0	1	1	0	31346	11400	19946	0	0	0	396
21-27134407-T-C	6.3743E-05	8.76732E-05	5.00751E-05	2	1	1	31376	11406	19970	0	0	0	274
21-27134413-C-G	3.18979E-05	0	5.01052E-05	1	0	1	31350	11392	19958	0	0	0	451
21-27134413-CTG-C	3.18979E-05	0	5.01052E-05	1	0	1	31350	11392	19958	0	0	0	343
21-27134452-G-C	0.000223328	0.000614358	0	7	7	0	31344	11394	19950	0	0	0	387
21-27134456-A-T	3.18857E-05	0	5.01052E-05	1	0	1	31362	11404	19958	0	0	0	184
21-27134462-T-C	3.18756E-05	0	5.00902E-05	1	0	1	31372	11408	19964	0	0	0	95
21-27134463-A-G	0.000159469	0.000438673	0	5	5	0	31354	11398	19956	0	0	0	151
21-27134465-T-G	6.37389E-05	0	0.00010015	2	0	2	31378	11408	19970	0	0	0	483
21-27134478-A-G	3.19122E-05	8.76732E-05	0	1	1	0	31336	11406	19930	0	0	0	337
21-27134481-C-T	0.000159561	0.000438135	0	5	5	0	31336	11412	19924	0	0	0	394
21-27134555-G-GTT	3.19224E-05	8.76732E-05	0	1	1	0	31326	11406	19920	0	0	0	131
21-27134557-T-A	9.57549E-05	0	0.000150542	3	0	3	31330	11402	19928	0	0	0	230
21-27134579-AT-A	3.19611E-05	8.77809E-05	0	1	1	0	31288	11392	19896	0	0	0	17
21-27134597-A-C	6.38121E-05	0.000175408	0	2	2	0	31342	11402	19940	0	0	0	2
21-27134606-A-G	3.18979E-05	8.76732E-05	0	1	1	0	31350	11406	19944	0	0	0	326
21-27134606-AT-A	3.18979E-05	0	5.01404E-05	1	0	1	31350	11406	19944	0	0	0	38
21-27134607-T-A	3.19244E-05	0	5.02008E-05	1	0	1	31324	11404	19920	0	0	0	167
21-27134644-A-G	3.18776E-05	8.76578E-05	0	1	1	0	31370	11408	19962	0	0	0	281
21-27134651-G-A	3.19142E-05	8.77039E-05	0	1	1	0	31334	11402	19932	0	0	0	357
21-27134667-A-G	6.37552E-05	0.000175316	0	2	2	0	31370	11408	19962	0	0	0	371
21-27134673-C-G	3.19142E-05	8.77347E-05	0	1	1	0	31334	11398	19936	0	0	0	413
21-27134675-A-G	3.18735E-05	0	5.00851E-05	1	0	1	31374	11408	19966	0	0	0	108
21-27134679-G-A	0.000287063	0.000789474	0	9	9	0	31352	11400	19952	0	0	0	445
21-27134700-C-A	3.19366E-05	0	5.02058E-05	1	0	1	31312	11394	19918	0	0	0	298
21-27134704-T-C	3.18756E-05	8.76578E-05	0	1	1	0	31372	11408	19964	0	0	0	473
21-27134715-G-T	3.19E-05	8.77347E-05	0	1	1	0	31348	11398	19950	0	0	0	94
21-27134733-C-T	0.000638121	0.001754694	0	20	20	0	31342	11398	19944	0	0	0	421
21-27134734-G-A	3.19183E-05	0	5.01555E-05	1	0	1	31330	11392	19938	0	0	0	222
21-27134744-AAAAAGG-A	3.18756E-05	8.76732E-05	0	1	1	0	31372	11406	19966	0	0	0	169
21-27134762-A-C	3.18593E-05	0	5.00551E-05	1	0	1	31388	11410	19978	0	0	0	23
21-27134766-A-G	3.18512E-05	0	5.004E-05	1	0	1	31396	11412	19984	0	0	0	489
21-27134781-CA-C	0.000670327	0.001843399	0	21	21	0	31328	11392	19936	0	0	0	279
21-27134789-A-G	3.18593E-05	0	5.00601E-05	1	0	1	31388	11412	19976	0	0	0	35
21-27134793-TTTG-T	3.18512E-05	8.76578E-05	0	1	1	0	31396	11408	19988	0	0	0	382
21-27134799-C-G	0.000191278	0.000526131	0	6	6	0	31368	11404	19964	0	0	0	239
21-27134815-C-A	9.56023E-05	0.000263112	0	3	3	0	31380	11402	19978	0	0	0	109
21-27134822-A-G	0.040039498	0.108607994	0.00090063	1257	1239	18	31394	11408	19986	85	85	0	136
21-27134837-C-T	6.37592E-05	0	0.00010017	2	0	2	31368	11402	19966	0	0	0	437
21-27134842-CAT-C	0.001210654	0.003330996	0	38	38	0	31388	11408	19980	0	0	0	447
21-27134844-T-C	3.18451E-05	8.76271E-05	0	1	1	0	31402	11412	19990	0	0	0	44
21-27134862-GATTAAC-G	3.18654E-05	8.76578E-05	0	1	1	0	31382	11408	19974	0	0	0	204
21-27134877-T-C	3.18431E-05	0	5.0015E-05	1	0	1	31404	11410	19994	0	0	0	171
21-27134891-A-T	0.033350322	0.090582252	0.00070035	1047	1033	14	31394	11404	19990	56	56	0	131
21-27134948-C-T	3.18613E-05	0	5.004E-05	1	0	1	31386	11402	19984	0	0	0	235
21-27134954-G-A	3.18552E-05	0	5.003E-05	1	0	1	31392	11404	19988	0	0	0	46
21-27135039-A-G	3.1841E-05	8.76271E-05	0	1	1	0	31406	11412	19994	0	0	0	200
21-27135055-T-G	3.1841E-05	8.76117E-05	0	1	1	0	31406	11414	19992	0	0	0	35
21-27135079-T-C	3.18492E-05	8.76424E-05	0	1	1	0	31398	11410	19988	0	0	0	293
21-27135104-A-G	0.552251677	0.352056962	0.666499448	17291	4005	13286	31310	11376	19934	5205	762	4443	252
21-27135128-G-T	3.18573E-05	0	5.0045E-05	1	0	1	31390	11408	19982	0	0	0	397
21-27135138-A-T	0.000191034	0.00052567	0	6	6	0	31408	11414	19994	0	0	0	399
21-27135140-T-C	3.18674E-05	8.76578E-05	0	1	1	0	31380	11408	19972	0	0	0	40
21-27135177-A-G	3.18512E-05	0	5.003E-05	1	0	1	31396	11408	19988	0	0	0	335
21-27135195-A-G	3.18512E-05	0	5.0045E-05	1	0	1	31396	11414	19982	0	0	0	390
21-27135216-G-A	3.18492E-05	8.76271E-05	0	1	1	0	31398	11412	19986	0	0	0	409
21-27135235-A-G	3.18552E-05	8.76424E-05	0	1	1	0	31392	11410	19982	0	0	0	120
21-27135239-C-G	3.18552E-05	0	5.004E-05	1	0	1	31392	11408	19984	0	0	0	476
21-27135263-C-G	3.18613E-05	8.77039E-05	0	1	1	0	31386	11402	19984	0	0	0	23
21-27135267-C-T	9.55657E-05	8.76424E-05	0.00010009	3	1	2	31392	11410	19982	0	0	0	200
21-27135269-C-A	0.009589041	0.02622807	0.00010005	301	299	2	31390	11400	19990	5	5	0	119
21-27135273-C-T	3.18593E-05	0	5.0035E-05	1	0	1	31388	11402	19986	0	0	0	415
21-27135280-A-G	3.18918E-05	0	5.00851E-05	1	0	1	31356	11390	19966	0	0	0	241
21-27135291-GC-G	0.000637471	0.00175531	0	20	20	0	31374	11394	19980	0	0	0	29
21-27135295-T-C	3.18593E-05	0	5.004E-05	1	0	1	31388	11404	19984	0	0	0	70
21-27135314-G-T	0.005038265	0.013781601	5.00801E-05	158	157	1	31360	11392	19968	4	4	0	89
21-27135341-T-C	3.18634E-05	0	5.004E-05	1	0	1	31384	11400	19984	0	0	0	258
21-27135355-A-G	0.000127567	0	0.0002003	4	0	4	31356	11386	19970	0	0	0	20
21-27135426-T-A	3.18471E-05	8.76578E-05	0	1	1	0	31400	11408	19992	0	0	0	124
21-27135469-C-T	6.37389E-05	0	0.00010015	2	0	2	31378	11408	19970	0	0	0	201
21-27135481-G-T	3.18735E-05	8.77039E-05	0	1	1	0	31374	11402	19972	0	0	0	271
21-27135483-G-A	3.18695E-05	8.77347E-05	0	1	1	0	31378	11398	19980	0	0	0	299
21-27135517-A-G	3.18471E-05	8.76424E-05	0	1	1	0	31400	11410	19990	0	0	0	13
21-27135524-A-G	6.37186E-05	0.000175377	0	2	2	0	31388	11404	19984	0	0	0	14
21-27135539-T-A	3.18593E-05	0	5.00551E-05	1	0	1	31388	11410	19978	0	0	0	3
21-27135561-G-A	3.18532E-05	8.76885E-05	0	1	1	0	31394	11404	19990	0	0	0	261
21-27135562-C-A	0.100223143	0.090366731	0.105848187	3144	1030	2114	31370	11398	19972	189	92	97	459
21-27135572-T-G	0.00070086	0	0.00110066	22	0	22	31390	11402	19988	0	0	0	122
21-27135577-T-G	0.001146643	0	0.001801261	36	0	36	31396	11410	19986	0	0	0	155
21-27135588-T-C	0.013065647	0.035169269	0.000450496	410	401	9	31380	11402	19978	10	10	0	406
21-27135589-C-T	6.37836E-05	0.000175408	0	2	2	0	31356	11402	19954	0	0	0	330
21-27135629-A-G	0.000254826	0.000701631	0	8	8	0	31394	11402	19992	0	0	0	442
21-27135631-A-G	9.5584E-05	0.000263204	0	3	3	0	31386	11398	19988	0	0	0	62
21-27135638-T-C	3.18471E-05	0	5.001E-05	1	0	1	31400	11404	19996	0	0	0	105
21-27135642-T-A	6.36821E-05	0.000175285	0	2	2	0	31406	11410	19996	0	0	0	95
21-27135656-G-C	0.000318695	0.000876885	0	10	10	0	31378	11404	19974	0	0	0	180
21-27135660-C-T	3.18512E-05	8.76117E-05	0	1	1	0	31396	11414	19982	0	0	0	500
21-27135661-G-A	3.18756E-05	8.77193E-05	0	1	1	0	31372	11400	19972	0	0	0	320
21-27135662-AAC-A	0.000509781	0.000175316	0.000700771	16	2	14	31386	11408	19978	0	0	0	2
21-27135695-A-C	3.18512E-05	0	5.004E-05	1	0	1	31396	11412	19984	0	0	0	321
21-27135721-A-G	9.55597E-05	0	0.000150105	3	0	3	31394	11408	19986	0	0	0	99
21-27135722-C-T	6.37471E-05	0.000175439	0	2	2	0	31374	11400	19974	0	0	0	13
21-27135744-C-A	3.18654E-05	8.76578E-05	0	1	1	0	31382	11408	19974	0	0	0	428
21-27135766-A-G	3.18512E-05	0	5.003E-05	1	0	1	31396	11408	19988	0	0	0	350
21-27135769-T-A	3.18573E-05	0	5.0035E-05	1	0	1	31390	11404	19986	0	0	0	76
21-27135783-T-C	0.000127462	0.000175439	0.00010009	4	2	2	31382	11400	19982	0	0	0	176
21-27135792-T-G	3.18573E-05	0	5.00501E-05	1	0	1	31390	11410	19980	0	0	0	332
21-27135793-G-A	3.18695E-05	0	5.00601E-05	1	0	1	31378	11402	19976	0	0	0	146
21-27135793-G-C	3.18695E-05	8.77039E-05	0	1	1	0	31378	11402	19976	0	0	0	209
21-27135794-T-A	3.18431E-05	0	5.0025E-05	1	0	1	31404	11414	19990	0	0	0	5
21-27135843-T-C	0.000350385	0.000963898	0	11	11	0	31394	11412	19982	0	0	0	411
21-27135852-G-A	3.18878E-05	0	5.01203E-05	1	0	1	31360	11408	19952	0	0	0	440
21-27135866-T-A	3.18451E-05	8.75964E-05	0	1	1	0	31402	11416	19986	0	0	0	311
21-27135875-CAACT-C	3.18735E-05	8.76885E-05	0	1	1	0	31374	11404	19970	0	0	0	36
21-27135887-C-T	0.000159337	0	0.00025035	5	0	5	31380	11408	19972	0	0	0	111
21-27135888-G-A	6.37592E-05	0	0.00010016	2	0	2	31368	11400	19968	0	0	0	390
21-27135915-CAT-C	6.37064E-05	0.000175254	0	2	2	0	31394	11412	19982	0	0	0	65
21-27135924-A-G	3.18492E-05	0	5.004E-05	1	0	1	31398	11414	19984	0	0	0	352
21-27135932-T-A	3.18552E-05	8.76424E-05	0	1	1	0	31392	11410	19982	0	0	0	111
21-27135946-T-G	3.18552E-05	8.76271E-05	0	1	1	0	31392	11412	19980	0	0	0	443
21-27135967-T-G	3.18512E-05	8.76117E-05	0	1	1	0	31396	11414	19982	0	0	0	385
21-27135996-G-T	3.18959E-05	8.76732E-05	0	1	1	0	31352	11406	19946	0	0	0	184
21-27136001-T-C	6.37146E-05	0.000175223	0	2	2	0	31390	11414	19976	0	0	0	176
21-27136009-G-A	6.37755E-05	0	0.000100231	2	0	2	31360	11406	19954	0	0	0	423
21-27136015-T-G	0.000159297	0.000438135	0	5	5	0	31388	11412	19976	0	0	0	219
21-27136046-G-A	3.18552E-05	8.76424E-05	0	1	1	0	31392	11410	19982	0	0	0	30
21-27136052-ACAT-A	6.37064E-05	8.76117E-05	5.00501E-05	2	1	1	31394	11414	19980	0	0	0	127
21-27136078-A-C	3.18552E-05	0	5.0045E-05	1	0	1	31392	11410	19982	0	0	0	370
21-27136086-G-A	3.18573E-05	8.76578E-05	0	1	1	0	31390	11408	19982	0	0	0	167
21-27136099-C-T	9.55962E-05	0.000262973	0	3	3	0	31382	11408	19974	0	0	0	462
21-27136111-A-G	9.56267E-05	0	0.000150255	3	0	3	31372	11406	19966	0	0	0	312
21-27136121-C-A	0.000254874	0.000701508	0	8	8	0	31388	11404	19984	0	0	0	77
21-27136130-A-G	6.37024E-05	0	0.00010008	2	0	2	31396	11412	19984	0	0	0	473
21-27136149-A-G	3.18512E-05	0	5.0035E-05	1	0	1	31396	11410	19986	0	0	0	452
21-27136202-A-T	3.19877E-05	0	5.02058E-05	1	0	1	31262	11344	19918	0	0	0	354
21-27136205-G-A	3.21978E-05	8.86839E-05	0	1	1	0	31058	11276	19782	0	0	0	173
21-27136220-T-C	0.001908117	0.000718243	0.002570547	52	7	45	27252	9746	17506	0	0	0	232
21-27136230-A-G	0.000124054	0.000353982	0	2	2	0	16122	5650	10472	0	0	0	364
21-27136246-A-ACT	0.969368851	0.916431345	0.999399279	30349	10385	19964	31308	11332	19976	14714	4738	9976	56
21-27136246-A-ACTCTCTTTGTCTAACT	0.000159704	0.000441228	0	5	5	0	31308	11332	19976	0	0	0	208
21-27136249-C-CTG	3.19285E-05	8.79817E-05	0	1	1	0	31320	11366	19954	0	0	0	167
21-27136255-C-G	0.000192468	0	0.000302419	6	0	6	31174	11334	19840	0	0	0	149
21-27136291-G-T	0.003473107	0.009294984	0.00015015	109	106	3	31384	11404	19980	1	1	0	493
21-27136297-T-C	6.37105E-05	0.000175316	0	2	2	0	31392	11408	19984	0	0	0	66
21-27136299-G-A	3.18613E-05	0	5.00501E-05	1	0	1	31386	11406	19980	0	0	0	34
21-27136310-G-T	3.18512E-05	0	5.003E-05	1	0	1	31396	11408	19988	0	0	0	319
21-27136323-T-C	3.18451E-05	8.76424E-05	0	1	1	0	31402	11410	19992	0	0	0	63
21-27136332-C-A	3.18634E-05	0	5.0035E-05	1	0	1	31384	11398	19986	0	0	0	397
21-27136332-C-T	3.18634E-05	0	5.0035E-05	1	0	1	31384	11398	19986	0	0	0	412
21-27136349-T-C	3.18492E-05	0	5.0035E-05	1	0	1	31398	11412	19986	0	0	0	252
21-27136364-T-C	3.18451E-05	0	5.0025E-05	1	0	1	31402	11412	19990	0	0	0	112
21-27136364-T-G	3.18451E-05	0	5.0025E-05	1	0	1	31402	11412	19990	0	0	0	197
21-27136382-A-T	6.38447E-05	0	0.000100422	2	0	2	31326	11410	19916	0	0	0	168
21-27136409-T-C	3.18796E-05	0	5.00902E-05	1	0	1	31368	11404	19964	0	0	0	261
21-27136425-T-C	9.56511E-05	8.77039E-05	0.00010019	3	1	2	31364	11402	19962	0	0	0	214
21-27136428-G-A	0.03420884	0.008887716	0.048700645	1068	101	967	31220	11364	19856	25	1	24	46
21-27136431-ATTAG-A	3.22082E-05	8.81679E-05	0	1	1	0	31048	11342	19706	0	0	0	230
21-27136440-A-C	3.1955E-05	0	5.0221E-05	1	0	1	31294	11382	19912	0	0	0	447
21-27136459-A-G	3.21234E-05	0	5.05766E-05	1	0	1	31130	11358	19772	0	0	0	56
21-27136483-T-C	3.19939E-05	8.77963E-05	0	1	1	0	31256	11390	19866	0	0	0	91
21-27136502-T-C	3.19142E-05	8.77809E-05	0	1	1	0	31334	11392	19942	0	0	0	428
21-27136564-T-C	6.37633E-05	8.77347E-05	5.00801E-05	2	1	1	31366	11398	19968	0	0	0	423
21-27136582-T-C	3.18654E-05	8.76578E-05	0	1	1	0	31382	11408	19974	0	0	0	381
21-27136614-C-T	3.1902E-05	0	5.01354E-05	1	0	1	31346	11400	19946	0	0	0	478
21-27136615-G-A	0.002168367	0.000350754	0.003207056	68	4	64	31360	11404	19956	0	0	0	74
21-27136642-C-G	3.18695E-05	8.76885E-05	0	1	1	0	31378	11404	19974	0	0	0	189
21-27136697-C-T	3.18857E-05	0	5.00851E-05	1	0	1	31362	11396	19966	0	0	0	284
21-27136702-T-G	0.000159317	0.000438366	0	5	5	0	31384	11406	19978	0	0	0	442
21-27136714-T-G	6.37267E-05	0.000175439	0	2	2	0	31384	11400	19984	0	0	0	399
21-27136731-G-C	0.006727458	0.018161081	0.000200341	211	207	4	31364	11398	19966	3	3	0	28
21-27136826-C-A	3.18654E-05	0	5.00651E-05	1	0	1	31382	11408	19974	0	0	0	66
21-27136857-G-T	3.18573E-05	0	5.004E-05	1	0	1	31390	11406	19984	0	0	0	131
21-27136922-C-A	6.37267E-05	8.76732E-05	5.00551E-05	2	1	1	31384	11406	19978	0	0	0	155
21-27136926-C-A	3.18593E-05	8.76271E-05	0	1	1	0	31388	11412	19976	0	0	0	133
21-27136928-A-G	6.37064E-05	0.000175285	0	2	2	0	31394	11410	19984	0	0	0	284
21-27136960-A-G	3.18613E-05	0	5.0045E-05	1	0	1	31386	11404	19982	0	0	0	234
21-27136964-C-T	3.18715E-05	8.76885E-05	0	1	1	0	31376	11404	19972	0	0	0	428
21-27136968-C-A	0.000255053	0.000614251	5.00751E-05	8	7	1	31366	11396	19970	0	0	0	202
21-27137016-C-G	6.37592E-05	0	0.00010013	2	0	2	31368	11394	19974	0	0	0	214
21-27137066-G-A	0.000191363	0.000526408	0	6	6	0	31354	11398	19956	0	0	0	495
21-27137102-A-T	0.032967734	0.089577119	0.000651107	1034	1021	13	31364	11398	19966	52	52	0	338
21-27137109-A-G	3.18796E-05	0	5.01002E-05	1	0	1	31368	11408	19960	0	0	0	443
21-27137121-T-G	3.18776E-05	0	5.01002E-05	1	0	1	31370	11410	19960	0	0	0	342
21-27137121-T-TC	3.18776E-05	0	5.01002E-05	1	0	1	31370	11410	19960	0	0	0	46
21-27137159-C-A	3.20225E-05	8.79198E-05	0	1	1	0	31228	11374	19854	0	0	0	377
21-27137175-T-C	3.19264E-05	0	5.01756E-05	1	0	1	31322	11392	19930	0	0	0	436
21-27137190-AATG-A	3.21626E-05	8.93495E-05	0	1	1	0	31092	11192	19900	0	0	0	393
21-27137213-GT-G	0.2284421	0.434163701	0.109667146	7015	4880	2135	30708	11240	19468	1236	1134	102	303
21-27137216-T-C	3.19346E-05	0	5.01958E-05	1	0	1	31314	11392	19922	0	0	0	7
21-27137220-TC-T	0.005166217	0.013795543	0.000251813	161	156	5	31164	11308	19856	0	0	0	166
21-27137245-A-T	3.20554E-05	8.81057E-05	0	1	1	0	31196	11350	19846	0	0	0	13
21-27137265-G-A	3.38272E-05	9.6768E-05	0	1	1	0	29562	10334	19228	0	0	0	197
21-27137273-G-GT	0.183689765	0.295179619	0.115694165	5291	3221	2070	28804	10912	17892	561	465	96	52
21-27137273-GT-G	0.017705874	0.044629765	0.001285491	510	487	23	28804	10912	17892	13	13	0	207
21-27137278-T-C	3.19326E-05	8.77347E-05	0	1	1	0	31316	11398	19918	0	0	0	321
21-27137286-A-C	0.000329164	0.000889838	0	10	10	0	30380	11238	19142	0	0	0	90
21-27137318-A-G	0.026049439	0.006885593	0.037183301	803	78	725	30826	11328	19498	17	0	17	39
21-27137326-G-A	3.23478E-05	0	5.10412E-05	1	0	1	30914	11322	19592	0	0	0	449
21-27137329-A-G	0.000192	0	0.000302024	6	0	6	31250	11384	19866	0	0	0	73
21-27137343-CA-C	0.002284927	0.005679702	0.000118821	63	61	2	27572	10740	16832	0	0	0	352
21-27137344-A-C	3.28106E-05	0	5.19642E-05	1	0	1	30478	11234	19244	0	0	0	199
21-27137352-AT-A	3.19428E-05	8.77193E-05	0	1	1	0	31306	11400	19906	0	0	0	326
21-27137359-A-T	3.19836E-05	0	5.0317E-05	1	0	1	31266	11392	19874	0	0	0	143
21-27137365-G-C	3.2173E-05	8.80902E-05	0	1	1	0	31082	11352	19730	0	0	0	405
21-27137379-TTGC-T	3.18918E-05	0	5.01253E-05	1	0	1	31356	11406	19950	0	0	0	224
21-27137387-A-T	3.18918E-05	0	5.01203E-05	1	0	1	31356	11404	19952	0	0	0	67
21-27137396-G-A	3.19387E-05	8.77501E-05	0	1	1	0	31310	11396	19914	0	0	0	298
21-27137402-G-A	0.000607068	0.001667252	0	19	19	0	31298	11396	19902	0	0	0	305
21-27137425-T-C	3.18959E-05	8.77809E-05	0	1	1	0	31352	11392	19960	0	0	0	362
21-27137433-G-C	0.00121336	0.003335674	0	38	38	0	31318	11392	19926	0	0	0	150
21-27137448-A-C	0.000382555	0.000175531	0.000500651	12	2	10	31368	11394	19974	0	0	0	185
21-27137477-T-C	3.18776E-05	8.76885E-05	0	1	1	0	31370	11404	19966	0	0	0	63
21-27137488-C-T	3.18837E-05	8.77347E-05	0	1	1	0	31364	11398	19966	0	0	0	113
21-27137524-G-A	3.19101E-05	8.78272E-05	0	1	1	0	31338	11386	19952	0	0	0	130
21-27137524-G-GT	3.19101E-05	8.78272E-05	0	1	1	0	31338	11386	19952	0	0	0	232
21-27137538-G-A	6.37918E-05	0.000175377	0	2	2	0	31352	11404	19948	0	0	0	97
21-27137553-T-A	3.18857E-05	0	5.01052E-05	1	0	1	31362	11404	19958	0	0	0	26
21-27137565-A-G	3.18715E-05	0	5.00851E-05	1	0	1	31376	11410	19966	0	0	0	98
21-27137574-A-G	0.031112528	0.085087719	0.000300451	976	970	6	31370	11400	19970	51	51	0	247
21-27137593-A-C	3.18613E-05	0	5.00651E-05	1	0	1	31386	11412	19974	0	0	0	51
21-27137595-C-T	3.18898E-05	8.76885E-05	0	1	1	0	31358	11404	19954	0	0	0	217
21-27137600-A-G	3.18735E-05	8.76578E-05	0	1	1	0	31374	11408	19966	0	0	0	31
21-27137602-A-G	9.56267E-05	0.000262973	0	3	3	0	31372	11408	19964	0	0	0	104
21-27137640-C-T	6.37836E-05	0.000175377	0	2	2	0	31356	11404	19952	0	0	0	13
21-27137641-G-A	0.000127543	0.000350631	0	4	4	0	31362	11408	19954	0	0	0	98
21-27137646-T-G	3.18857E-05	8.76732E-05	0	1	1	0	31362	11406	19956	0	0	0	13
21-27137648-TG-T	3.18796E-05	8.76885E-05	0	1	1	0	31368	11404	19964	0	0	0	315
21-27137651-C-G	3.18857E-05	8.76578E-05	0	1	1	0	31362	11408	19954	0	0	0	368
21-27137682-T-C	0.000350586	0.000876578	5.00801E-05	11	10	1	31376	11408	19968	0	0	0	439
21-27137698-G-A	0.100421483	0.090549798	0.106060606	3145	1031	2114	31318	11386	19932	188	92	96	240
21-27137710-A-G	3.18857E-05	8.77193E-05	0	1	1	0	31362	11400	19962	0	0	0	239
21-27137713-G-A	3.19061E-05	0	5.01253E-05	1	0	1	31342	11392	19950	0	0	0	110
21-27137717-G-A	3.18918E-05	0	5.01102E-05	1	0	1	31356	11400	19956	0	0	0	286
21-27137747-C-T	0.023747207	0.064762742	0.000350877	744	737	7	31330	11380	19950	30	30	0	43
21-27137767-T-G	3.18878E-05	0	5.01002E-05	1	0	1	31360	11400	19960	0	0	0	228
21-27137773-T-G	9.56999E-05	0.000263296	0	3	3	0	31348	11394	19954	0	0	0	43
21-27137778-T-TCA	3.19877E-05	8.79662E-05	0	1	1	0	31262	11368	19894	0	0	0	2
21-27137787-C-G	6.37592E-05	0.000175439	0	2	2	0	31368	11400	19968	0	0	0	364
21-27137790-A-T	3.20431E-05	8.82457E-05	0	1	1	0	31208	11332	19876	0	0	0	254
21-27137795-C-G	3.18939E-05	0	5.01153E-05	1	0	1	31354	11400	19954	0	0	0	439
21-27137799-T-A	3.19061E-05	8.77347E-05	0	1	1	0	31342	11398	19944	0	0	0	110
21-27137840-T-C	0.000191327	0.000175346	0.000200461	6	2	4	31360	11406	19954	0	0	0	472
21-27137856-C-T	0.000510237	0.001403016	0	16	16	0	31358	11404	19954	1	1	0	480
21-27137858-G-A	3.19E-05	8.77039E-05	0	1	1	0	31348	11402	19946	0	0	0	6
21-27137867-C-G	3.18898E-05	8.77193E-05	0	1	1	0	31358	11400	19958	0	0	0	40
21-27137875-C-T	0.007304159	0.000263204	0.01132605	229	3	226	31352	11398	19954	6	0	6	263
21-27137882-A-G	3.18959E-05	8.77809E-05	0	1	1	0	31352	11392	19960	0	0	0	410
21-27137883-C-G	0.001468429	0.00403934	0	46	46	0	31326	11388	19938	0	0	0	48
21-27137883-C-T	3.19224E-05	8.78117E-05	0	1	1	0	31326	11388	19938	0	0	0	122
21-27137888-A-T	3.18837E-05	8.77193E-05	0	1	1	0	31364	11400	19964	0	0	0	133
21-27137893-A-C	3.18715E-05	0	5.00651E-05	1	0	1	31376	11402	19974	0	0	0	351
21-27137899-A-G	0.000127527	0.000350877	0	4	4	0	31366	11400	19966	1	1	0	322
21-27137901-T-G	3.18674E-05	0	5.00601E-05	1	0	1	31380	11404	19976	0	0	0	432
21-27137964-G-A	3.19E-05	8.77501E-05	0	1	1	0	31348	11396	19952	0	0	0	487
21-27137998-C-T	3.19203E-05	0	5.01555E-05	1	0	1	31328	11390	19938	0	0	0	251
21-27138017-A-G	0.000159469	0.000438443	0	5	5	0	31354	11404	19950	0	0	0	249
21-27138033-C-G	3.18837E-05	8.76732E-05	0	1	1	0	31364	11406	19958	0	0	0	28
21-27138040-T-A	3.18878E-05	8.76578E-05	0	1	1	0	31360	11408	19952	0	0	0	235
21-27138045-C-T	3.19061E-05	8.77347E-05	0	1	1	0	31342	11398	19944	0	0	0	116
21-27138054-T-C	3.18715E-05	8.76578E-05	0	1	1	0	31376	11408	19968	0	0	0	133
21-27138077-G-T	0.001180073	0.003067485	0.000100281	37	35	2	31354	11410	19944	0	0	0	1
21-27138092-T-C	3.18695E-05	8.76424E-05	0	1	1	0	31378	11410	19968	0	0	0	470
21-27138093-T-A	3.18715E-05	0	5.00751E-05	1	0	1	31376	11406	19970	0	0	0	224
21-27138102-A-G	3.18613E-05	0	5.00551E-05	1	0	1	31386	11408	19978	0	0	0	451
21-27138106-G-A	3.18634E-05	8.76271E-05	0	1	1	0	31384	11412	19972	0	0	0	43
21-27138115-A-C	6.37674E-05	0.000175377	0	2	2	0	31364	11404	19960	0	0	0	473
21-27138131-G-A	3.19632E-05	8.80282E-05	0	1	1	0	31286	11360	19926	0	0	0	176
21-27138140-A-G	0.000289519	0.000177999	0.000352645	9	2	7	31086	11236	19850	0	0	0	410
21-27138144-A-C	0.000225981	0.000626679	0	7	7	0	30976	11170	19806	0	0	0	179
21-27138158-T-TC	0.121294403	0.147803163	0.106153383	3797	1682	2115	31304	11380	19924	248	151	97	343
21-27138158-TC-T	0.000415282	0.000351494	0.000451717	13	4	9	31304	11380	19924	0	0	0	370
21-27138186-G-T	3.18837E-05	0	5.00952E-05	1	0	1	31364	11402	19962	0	0	0	356
21-27138238-A-T	6.37511E-05	8.76732E-05	5.00851E-05	2	1	1	31372	11406	19966	0	0	0	450
21-27138327-C-T	3.18776E-05	8.76424E-05	0	1	1	0	31370	11410	19960	0	0	0	284
21-27138346-C-G	3.18776E-05	0	5.01052E-05	1	0	1	31370	11412	19958	0	0	0	97
21-27138351-G-A	3.18857E-05	8.76271E-05	0	1	1	0	31362	11412	19950	0	0	0	367
21-27138360-A-G	3.18735E-05	8.76117E-05	0	1	1	0	31374	11414	19960	0	0	0	106
21-27138390-A-C	3.18695E-05	8.75964E-05	0	1	1	0	31378	11416	19962	0	0	0	379
21-27138390-A-G	3.18695E-05	8.75964E-05	0	1	1	0	31378	11416	19962	0	0	0	415
21-27138409-T-C	3.18857E-05	8.76578E-05	0	1	1	0	31362	11408	19954	0	0	0	329
21-27138421-A-G	0.001625135	0.001139152	0.001902854	51	13	38	31382	11412	19970	1	1	0	21
21-27138440-A-C	0.000318817	0.000876732	0	10	10	0	31366	11406	19960	0	0	0	26
21-27138443-AT-A	0.002263165	0.000876578	0.0030555	71	10	61	31372	11408	19964	0	0	0	374
21-27138469-G-A	3.18796E-05	8.76578E-05	0	1	1	0	31368	11408	19960	0	0	0	99
21-27138471-GA-G	3.18715E-05	8.76117E-05	0	1	1	0	31376	11414	19962	0	0	0	107
21-27138476-CAT-C	3.18796E-05	0	5.01052E-05	1	0	1	31368	11410	19958	0	0	0	214
21-27138480-T-C	3.18674E-05	0	5.00851E-05	1	0	1	31380	11414	19966	0	0	0	483
21-27138489-G-A	3.18776E-05	8.75964E-05	0	1	1	0	31370	11416	19954	0	0	0	380
21-27138509-G-C	3.18776E-05	8.77039E-05	0	1	1	0	31370	11402	19968	0	0	0	82
21-27138529-C-A	3.18695E-05	8.76578E-05	0	1	1	0	31378	11408	19970	0	0	0	438
21-27138540-G-A	3.18715E-05	0	5.00902E-05	1	0	1	31376	11412	19964	0	0	0	39
21-27138543-A-G	3.18634E-05	0	5.00701E-05	1	0	1	31384	11412	19972	0	0	0	66
21-27138556-C-G	6.3743E-05	0.000175316	0	2	2	0	31376	11408	19968	0	0	0	113
21-27138562-G-A	3.18695E-05	8.76424E-05	0	1	1	0	31378	11410	19968	0	0	0	145
21-27138571-G-A	3.19081E-05	8.76732E-05	0	1	1	0	31340	11406	19934	0	0	0	17
21-27138584-A-G	3.18593E-05	0	5.00601E-05	1	0	1	31388	11412	19976	0	0	0	236
21-27138604-C-T	0.0006696	0.001840813	0	21	21	0	31362	11408	19954	0	0	0	434
21-27138631-G-T	3.18898E-05	8.76732E-05	0	1	1	0	31358	11406	19952	0	0	0	30
21-27138704-G-C	0.000350765	0.000876885	5.01102E-05	11	10	1	31360	11404	19956	0	0	0	297
21-27138706-A-G	3.18756E-05	8.76732E-05	0	1	1	0	31372	11406	19966	0	0	0	475
21-27138708-A-G	3.18715E-05	0	5.00701E-05	1	0	1	31376	11404	19972	0	0	0	304
21-27138709-G-T	0.00038258	8.76732E-05	0.000551102	12	1	11	31366	11406	19960	0	0	0	440
21-27138724-CT-C	6.37714E-05	0.000175377	0	2	2	0	31362	11404	19958	0	0	0	24
21-27138725-T-A	3.18756E-05	0	5.00952E-05	1	0	1	31372	11410	19962	0	0	0	25
21-27138726-A-G	3.18776E-05	0	5.00952E-05	1	0	1	31370	11408	19962	0	0	0	314
21-27138744-T-A	0.000286935	0.00078892	0	9	9	0	31366	11408	19958	0	0	0	205
21-27138750-C-T	0.00025507	0.000613712	5.01052E-05	8	7	1	31364	11406	19958	0	0	0	432
21-27138763-A-T	3.18756E-05	8.76885E-05	0	1	1	0	31372	11404	19968	0	0	0	199
21-27138783-C-T	0.000318939	0.000877039	0	10	10	0	31354	11402	19952	0	0	0	111
21-27138796-C-G	3.18878E-05	0	5.01102E-05	1	0	1	31360	11404	19956	0	0	0	199
21-27138807-A-G	3.18959E-05	0	5.01153E-05	1	0	1	31352	11398	19954	0	0	0	305
21-27138812-A-G	6.37714E-05	0.000175377	0	2	2	0	31362	11404	19958	0	0	0	20
21-27138826-A-T	9.56328E-05	0.000263066	0	3	3	0	31370	11404	19966	0	0	0	430
21-27138858-C-A	3.1904E-05	8.77809E-05	0	1	1	0	31344	11392	19952	0	0	0	401
21-27138858-C-T	6.38081E-05	0	0.000100241	2	0	2	31344	11392	19952	0	0	0	120
21-27138867-A-G	6.37349E-05	0.000175316	0	2	2	0	31380	11408	19972	0	0	0	214
21-27138895-A-G	0.003507206	0.000876578	0.005011024	110	10	100	31364	11408	19956	0	0	0	150
21-27138899-A-G	0.001211271	0.003330996	0	38	38	0	31372	11408	19964	0	0	0	399
21-27138908-C-T	0.000127657	0.000351	0	4	4	0	31334	11396	19938	0	0	0	500
21-27138915-A-T	3.18918E-05	8.76578E-05	0	1	1	0	31356	11408	19948	0	0	0	390
21-27138971-C-T	0.000127592	0	0.000200501	4	0	4	31350	11400	19950	0	0	0	28
21-27138971-CT-C	0.001212121	0.003333333	0	38	38	0	31350	11400	19950	1	1	0	8
21-27138975-A-G	0.000127559	0.000262927	5.01303E-05	4	3	1	31358	11410	19948	0	0	0	122
21-27138993-G-A	3.1902E-05	8.77809E-05	0	1	1	0	31346	11392	19954	0	0	0	451
21-27139025-G-A	9.56755E-05	0.000263296	0	3	3	0	31356	11394	19962	0	0	0	409
21-27139027-G-A	3.18918E-05	0	5.00952E-05	1	0	1	31356	11394	19962	0	0	0	256
21-27139039-C-T	0.000318959	0.000877347	0	10	10	0	31352	11398	19954	0	0	0	434
21-27139055-A-G	0.0002552	0.000701754	0	8	8	0	31348	11400	19948	0	0	0	50
21-27139058-A-C	3.1902E-05	0	5.01253E-05	1	0	1	31346	11396	19950	0	0	0	213
21-27139068-G-T	3.1902E-05	8.77347E-05	0	1	1	0	31346	11398	19948	0	0	0	181
21-27139077-G-A	3.19101E-05	0	5.01354E-05	1	0	1	31338	11392	19946	0	0	0	315
21-27139083-C-G	6.38366E-05	0.000175654	0	2	2	0	31330	11386	19944	0	0	0	366
21-27139089-A-G	3.18979E-05	8.77501E-05	0	1	1	0	31350	11396	19954	0	0	0	78
21-27139098-A-G	3.18837E-05	0	5.00952E-05	1	0	1	31364	11402	19962	0	0	0	211
21-27139120-C-G	0.000191327	0.000526685	0	6	6	0	31360	11392	19968	0	0	0	81
21-27139122-T-A	0.000191375	0	0.000300571	6	0	6	31352	11390	19962	0	0	0	365
21-27139125-A-G	3.18837E-05	8.77501E-05	0	1	1	0	31364	11396	19968	0	0	0	440
21-27139133-A-G	3.18878E-05	0	5.00851E-05	1	0	1	31360	11394	19966	0	0	0	427
21-27139135-A-G	0.000127543	0.000351124	0	4	4	0	31362	11392	19970	0	0	0	364
21-27139136-CAT-C	6.37796E-05	0	0.00010018	2	0	2	31358	11394	19964	0	0	0	85
21-27139142-C-G	3.18857E-05	8.77193E-05	0	1	1	0	31362	11400	19962	0	0	0	144
21-27139147-C-T	0.000191314	0	0.000300481	6	0	6	31362	11394	19968	0	0	0	169
21-27139172-CA-C	3.19203E-05	8.78272E-05	0	1	1	0	31328	11386	19942	0	0	0	465
21-27139181-C-T	3.1902E-05	0	5.01153E-05	1	0	1	31346	11392	19954	0	0	0	464
21-27139182-C-T	0.000255314	0.000702864	0	8	8	0	31334	11382	19952	0	0	0	234
21-27139185-A-T	3.18959E-05	8.77501E-05	0	1	1	0	31352	11396	19956	0	0	0	283
21-27139226-T-C	9.56328E-05	0.000263112	0	3	3	0	31370	11402	19968	0	0	0	97
21-27139264-C-G	0.000637349	0.001754078	0	20	20	0	31380	11402	19978	0	0	0	70
21-27139269-TACAA-T	0.000159337	8.76578E-05	0.00020028	5	1	4	31380	11408	19972	0	0	0	347
21-27139289-C-T	3.18695E-05	8.76732E-05	0	1	1	0	31378	11406	19972	0	0	0	450
21-27139307-C-T	3.18695E-05	0	5.00751E-05	1	0	1	31378	11408	19970	0	0	0	100
21-27139308-A-G	0.000254939	0.000701262	0	8	8	0	31380	11408	19972	0	0	0	134
21-27139342-G-A	0.000159388	0	0.000250526	5	0	5	31370	11412	19958	0	0	0	217
21-27139354-TTA-T	9.56145E-05	0	0.000150255	3	0	3	31376	11410	19966	0	0	0	113
21-27139363-A-C	0.000127462	0	0.00020028	4	0	4	31382	11410	19972	0	0	0	267
21-27139373-A-G	3.18695E-05	8.76117E-05	0	1	1	0	31378	11414	19964	0	0	0	41
21-27139385-T-TA	3.18837E-05	8.76578E-05	0	1	1	0	31364	11408	19956	0	0	0	166
21-27139388-A-G	0.000318735	0.000175346	0.000400641	10	2	8	31374	11406	19968	0	0	0	214
21-27139440-A-G	3.18776E-05	0	5.00902E-05	1	0	1	31370	11406	19964	0	0	0	282
21-27139445-A-G	3.18857E-05	0	5.01002E-05	1	0	1	31362	11402	19960	0	0	0	254
21-27139457-G-GA	0.000765404	0.002106002	0	24	24	0	31356	11396	19960	0	0	0	424
21-27139458-A-T	3.19305E-05	8.80437E-05	0	1	1	0	31318	11358	19960	0	0	0	399
21-27139497-G-C	0.000159398	0	0.000250426	5	0	5	31368	11402	19966	0	0	0	125
21-27139516-T-TA	0.00015951	0.000438443	0	5	5	0	31346	11404	19942	0	0	0	92
21-27139529-A-G	6.37918E-05	0	0.000100251	2	0	2	31352	11402	19950	0	0	0	106
21-27139547-G-C	6.38203E-05	0	0.000100281	2	0	2	31338	11394	19944	0	0	0	11
21-27139551-C-G	3.19101E-05	8.77963E-05	0	1	1	0	31338	11390	19948	0	0	0	190
21-27139574-G-A	0.000127535	0.000350754	0	4	4	0	31364	11404	19960	0	0	0	251
21-27139615-C-G	3.19305E-05	0	5.01958E-05	1	0	1	31318	11396	19922	0	0	0	64
21-27139627-C-T	3.19591E-05	0	5.02311E-05	1	0	1	31290	11382	19908	0	0	0	398
21-27139628-TTTTG-T	6.37714E-05	0.000175377	0	2	2	0	31362	11404	19958	0	0	0	409
21-27139634-T-A	3.18918E-05	0	5.01102E-05	1	0	1	31356	11400	19956	0	0	0	303
21-27139649-G-A	3.1957E-05	0	5.02462E-05	1	0	1	31292	11390	19902	0	0	0	147
21-27139656-A-G	3.18857E-05	0	5.01052E-05	1	0	1	31362	11404	19958	0	0	0	412
21-27139657-A-G	3.18878E-05	8.77039E-05	0	1	1	0	31360	11402	19958	0	0	0	234
21-27139663-T-TA	9.59325E-05	0.00026362	0	3	3	0	31272	11380	19892	0	0	0	166
21-27139680-A-T	0.003626238	0.009833451	5.10256E-05	112	111	1	30886	11288	19598	0	0	0	430
21-27139686-AAAG-A	0.000191217	8.76424E-05	0.000250401	6	1	5	31378	11410	19968	0	0	0	445
21-27139687-AAG-A	3.18837E-05	8.76732E-05	0	1	1	0	31364	11406	19958	0	0	0	131
21-27139692-G-A	0.000223428	8.77347E-05	0.000301023	7	1	6	31330	11398	19932	0	0	0	275
21-27139694-A-C	3.18878E-05	0	5.01002E-05	1	0	1	31360	11400	19960	0	0	0	442
21-27139696-G-A	3.1953E-05	8.7858E-05	0	1	1	0	31296	11382	19914	0	0	0	153
21-27139697-A-G	9.56511E-05	0.000175346	5.01052E-05	3	2	1	31364	11406	19958	0	0	0	91
21-27139697-AAAAG-A	0.00146665	0.004032965	0	46	46	0	31364	11406	19958	0	0	0	236
21-27139701-GA-G	6.38529E-05	0	0.000100341	2	0	2	31322	11390	19932	0	0	0	427
21-27139721-C-T	3.19163E-05	8.77809E-05	0	1	1	0	31332	11392	19940	0	0	0	349
21-27139756-A-G	3.18857E-05	8.77193E-05	0	1	1	0	31362	11400	19962	0	0	0	33
21-27139774-T-C	3.18715E-05	0	5.00751E-05	1	0	1	31376	11406	19970	0	0	0	404
21-27139775-A-C	0.002199133	0.005960729	5.00801E-05	69	68	1	31376	11408	19968	0	0	0	453
21-27139792-G-A	0.003538864	0.001578394	0.004658852	111	18	93	31366	11404	19962	0	0	0	376
21-27139805-C-T	3.18979E-05	8.77193E-05	0	1	1	0	31350	11400	19950	0	0	0	496
21-27139806-A-C	3.18634E-05	8.76424E-05	0	1	1	0	31384	11410	19974	0	0	0	421
21-27139821-T-C	3.18695E-05	8.76732E-05	0	1	1	0	31378	11406	19972	0	0	0	246
21-27139848-CTTT-C	3.19122E-05	8.77501E-05	0	1	1	0	31336	11396	19940	0	0	0	101
21-27139852-T-C	0.003634277	0.009998246	0	114	114	0	31368	11402	19966	0	0	0	98
21-27139866-C-G	3.19142E-05	8.7858E-05	0	1	1	0	31334	11382	19952	0	0	0	122
21-27139892-A-G	3.18939E-05	0	5.00851E-05	1	0	1	31354	11388	19966	0	0	0	470
21-27139915-CCT-C	6.37471E-05	0.000175439	0	2	2	0	31374	11400	19974	0	0	0	168
21-27139934-T-G	3.18552E-05	8.76117E-05	0	1	1	0	31392	11414	19978	0	0	0	355
21-27139937-T-G	3.19122E-05	8.76578E-05	0	1	1	0	31336	11408	19928	0	0	0	62
21-27139943-T-C	6.37511E-05	0.000175285	0	2	2	0	31372	11410	19962	0	0	0	18
21-27139949-C-T	0.000192086	0.000263389	0.000151164	6	3	3	31236	11390	19846	0	0	0	18
21-27139950-G-A	9.6494E-05	0.000176211	5.06586E-05	3	2	1	31090	11350	19740	0	0	0	380
21-27139961-CAT-C	3.18878E-05	0	5.01153E-05	1	0	1	31360	11406	19954	0	0	0	134
21-27139970-G-A	3.18979E-05	8.77039E-05	0	1	1	0	31350	11402	19948	0	0	0	108
21-27139982-T-G	6.37227E-05	0.000175316	0	2	2	0	31386	11408	19978	0	0	0	463
21-27139991-T-G	3.18654E-05	0	5.00651E-05	1	0	1	31382	11408	19974	0	0	0	152
21-27139995-AT-A	3.18593E-05	0	5.00601E-05	1	0	1	31388	11412	19976	0	0	0	74
21-27139996-T-G	0.000891777	0.001752234	0.00040032	28	20	8	31398	11414	19984	0	0	0	369
21-27140001-A-G	3.18593E-05	8.76271E-05	0	1	1	0	31388	11412	19976	0	0	0	229
21-27140039-A-G	0.023671467	0.064527442	0.000350315	743	736	7	31388	11406	19982	30	30	0	40
21-27140041-G-A	0.000159286	0.000438059	0	5	5	0	31390	11414	19976	0	0	0	424
21-27140064-T-G	3.18593E-05	8.76271E-05	0	1	1	0	31388	11412	19976	0	0	0	8
21-27140072-T-C	3.18613E-05	0	5.00651E-05	1	0	1	31386	11412	19974	0	0	0	445
21-27140117-T-G	3.18654E-05	8.76578E-05	0	1	1	0	31382	11408	19974	0	0	0	26
21-27140134-A-G	3.18634E-05	0	5.00651E-05	1	0	1	31384	11410	19974	0	0	0	341
21-27140138-C-G	0.000350743	0.000876578	5.01153E-05	11	10	1	31362	11408	19954	0	0	0	323
21-27140178-A-G	3.18715E-05	0	5.00851E-05	1	0	1	31376	11410	19966	0	0	0	111
21-27140197-A-C	6.37146E-05	0.000175254	0	2	2	0	31390	11412	19978	0	0	0	91
21-27140201-C-G	9.56084E-05	0.000262973	0	3	3	0	31378	11408	19970	0	0	0	156
21-27140230-A-G	3.18613E-05	8.76424E-05	0	1	1	0	31386	11410	19976	0	0	0	356
21-27140266-C-T	9.55536E-05	0	0.000150135	3	0	3	31396	11414	19982	0	0	0	269
21-27140276-T-G	0.023730649	0.06466877	0.000350315	745	738	7	31394	11412	19982	30	30	0	245
21-27140345-C-T	3.18593E-05	0	5.00601E-05	1	0	1	31388	11412	19976	0	0	0	124
21-27140347-A-G	3.18573E-05	8.76424E-05	0	1	1	0	31390	11410	19980	0	0	0	249
21-27140351-G-T	0.000318674	0.000788782	5.00751E-05	10	9	1	31380	11410	19970	0	0	0	73
21-27140357-C-T	3.18593E-05	8.76424E-05	0	1	1	0	31388	11410	19978	0	0	0	347
21-27140372-A-C	0.002676864	0.007367129	0	84	84	0	31380	11402	19978	0	0	0	189
21-27140426-A-G	0.008571793	0.022452201	0.000650651	269	256	13	31382	11402	19980	4	4	0	308
21-27140438-C-G	3.18756E-05	8.77193E-05	0	1	1	0	31372	11400	19972	0	0	0	445
21-27140454-TC-T	3.18796E-05	8.76732E-05	0	1	1	0	31368	11406	19962	0	0	0	106
21-27140455-C-A	3.18715E-05	8.76885E-05	0	1	1	0	31376	11404	19972	0	0	0	497
21-27140457-A-G	3.18654E-05	0	5.00651E-05	1	0	1	31382	11408	19974	0	0	0	242
21-27140464-T-C	0.009114666	0.024991231	5.00651E-05	286	285	1	31378	11404	19974	2	2	0	154
21-27140467-G-T	0.000255037	8.76732E-05	0.000350666	8	1	7	31368	11406	19962	0	0	0	277
21-27140474-T-C	9.56023E-05	0.000175408	5.00551E-05	3	2	1	31380	11402	19978	0	0	0	395
21-27140475-A-G	3.18776E-05	8.77039E-05	0	1	1	0	31370	11402	19968	0	0	0	432
21-27140490-A-G	0.001274779	0.003508772	0	40	40	0	31378	11400	19978	0	0	0	277
21-27140500-T-C	3.18796E-05	8.77501E-05	0	1	1	0	31368	11396	19972	0	0	0	211
21-27140514-C-T	0.009086272	0.024925399	5.00701E-05	285	284	1	31366	11394	19972	2	2	0	494
21-27140536-T-C	0.000892459	0.002457434	0	28	28	0	31374	11394	19980	0	0	0	499
21-27140556-A-G	0.00012747	0	0.00020026	4	0	4	31380	11406	19974	0	0	0	291
21-27140565-T-C	3.18674E-05	0	5.00651E-05	1	0	1	31380	11406	19974	0	0	0	162
21-27140568-C-G	0.100197906	0.090254609	0.105878222	3139	1028	2111	31328	11390	19938	186	91	95	79
21-27140576-C-G	6.38814E-05	0	0.000100442	2	0	2	31308	11396	19912	0	0	0	268
21-27140585-C-G	3.18796E-05	8.76578E-05	0	1	1	0	31368	11408	19960	0	0	0	355
21-27140600-C-T	0.000191302	0.000526408	0	6	6	0	31364	11398	19966	0	0	0	385
21-27140601-T-G	3.18634E-05	8.76732E-05	0	1	1	0	31384	11406	19978	0	0	0	484
21-27140614-T-G	3.18634E-05	8.76424E-05	0	1	1	0	31384	11410	19974	0	0	0	334
21-27140621-C-A	0.006755465	0.018239214	0.00020022	212	208	4	31382	11404	19978	3	3	0	387
21-27140653-T-G	3.18532E-05	8.76117E-05	0	1	1	0	31394	11414	19980	0	0	0	446
21-27140661-G-A	0.001180073	0.002105633	0.000651433	37	24	13	31354	11398	19956	0	0	0	342
21-27140669-A-G	3.18593E-05	8.76578E-05	0	1	1	0	31388	11408	19980	0	0	0	400
21-27140703-A-G	3.18593E-05	0	5.00501E-05	1	0	1	31388	11408	19980	0	0	0	339
21-27140727-AAAG-A	0.000127478	8.76885E-05	0.000150195	4	1	3	31378	11404	19974	0	0	0	237
21-27140739-T-A	3.18817E-05	0	5.01102E-05	1	0	1	31366	11410	19956	0	0	0	499
21-27140742-A-G	3.18918E-05	0	5.01153E-05	1	0	1	31356	11402	19954	0	0	0	225
21-27140750-AT-A	0.001213437	0.003333918	0	38	38	0	31316	11398	19918	0	0	0	6
21-27140758-T-G	0.196543794	0.353085986	0.107214529	6153	4016	2137	31306	11374	19932	843	742	101	158
21-27140767-G-A	3.1953E-05	8.77655E-05	0	1	1	0	31296	11394	19902	0	0	0	328
21-27140794-G-T	6.37999E-05	0.000175469	0	2	2	0	31348	11398	19950	0	0	0	189
21-27140806-G-A	3.18756E-05	0	5.00801E-05	1	0	1	31372	11404	19968	0	0	0	477
21-27140817-T-C	3.18674E-05	0	5.00701E-05	1	0	1	31380	11408	19972	0	0	0	401
21-27140825-A-G	3.18695E-05	0	5.00751E-05	1	0	1	31378	11408	19970	0	0	0	323
21-27140833-T-C	0.000223086	0.000175316	0.000250376	7	2	5	31378	11408	19970	0	0	0	316
21-27140865-A-G	0.00341199	0.009303142	5.00851E-05	107	106	1	31360	11394	19966	1	1	0	42
21-27140881-A-G	3.18776E-05	8.77039E-05	0	1	1	0	31370	11402	19968	0	0	0	42
21-27140937-G-A	0.001085222	0.000701878	0.001304435	34	8	26	31330	11398	19932	0	0	0	99
21-27140944-CA-C	3.19061E-05	8.77193E-05	0	1	1	0	31342	11400	19942	0	0	0	404
21-27140980-C-T	9.57488E-05	0.000263158	0	3	3	0	31332	11400	19932	0	0	0	209
21-27140989-T-G	3.18918E-05	0	5.01203E-05	1	0	1	31356	11404	19952	0	0	0	69
21-27140991-G-C	3.1955E-05	8.77655E-05	0	1	1	0	31294	11394	19900	0	0	0	301
21-27140996-T-G	3.19101E-05	8.77039E-05	0	1	1	0	31338	11402	19936	0	0	0	120
21-27141004-TCTA-T	0.001180223	0.000175346	0.001754914	37	2	35	31350	11406	19944	0	0	0	182
21-27141026-G-A	3.20862E-05	0	5.05357E-05	1	0	1	31166	11378	19788	0	0	0	182
21-27141032-T-C	3.18959E-05	0	5.01354E-05	1	0	1	31352	11406	19946	0	0	0	458
21-27141058-T-C	0.000988583	0.000525947	0.001253133	31	6	25	31358	11408	19950	0	0	0	162
21-27141080-T-C	3.18695E-05	8.76424E-05	0	1	1	0	31378	11410	19968	0	0	0	172
21-27141090-G-A	3.18857E-05	0	5.01052E-05	1	0	1	31362	11404	19958	0	0	0	494
21-27141096-T-C	3.18634E-05	0	5.00501E-05	1	0	1	31384	11404	19980	0	0	0	250
21-27141097-G-A	0.009244501	0.025272025	0.00010013	290	288	2	31370	11396	19974	5	5	0	51
21-27141117-G-A	6.37755E-05	8.77039E-05	5.01052E-05	2	1	1	31360	11402	19958	0	0	0	36
21-27141145-G-A	3.18776E-05	8.76578E-05	0	1	1	0	31370	11408	19962	0	0	0	102
21-27141184-A-T	3.18613E-05	8.77039E-05	0	1	1	0	31386	11402	19984	0	0	0	34
21-27141203-A-G	0.004302377	0.011750263	5.00651E-05	135	134	1	31378	11404	19974	2	2	0	158
21-27141211-G-A	0.000255249	0.000175654	0.000300661	8	2	6	31342	11386	19956	0	0	0	180
21-27141244-A-C	3.27998E-05	0	5.1398E-05	1	0	1	30488	11032	19456	0	0	0	52
21-27141249-T-C	0.00024113	0	0.000377521	7	0	7	29030	10488	18542	0	0	0	427
21-27141273-C-CATTT	0.839948619	0.83874669	0.840636042	26156	9503	16653	31140	11330	19810	11006	3983	7023	342
21-27141292-A-G	0.121011574	0.147441533	0.10590836	3785	1677	2108	31278	11374	19904	244	147	97	171
21-27141293-A-T	6.43542E-05	0.000176803	0	2	2	0	31078	11312	19766	0	0	0	382
21-27141293-AT-A	9.65313E-05	0	0.000151776	3	0	3	31078	11312	19766	0	0	0	340
21-27141357-G-A	0.00471668	0.012894737	5.00551E-05	148	147	1	31378	11400	19978	4	4	0	35
21-27141375-T-C	3.18512E-05	0	5.003E-05	1	0	1	31396	11408	19988	0	0	0	381
21-27141449-A-G	3.18552E-05	8.77039E-05	0	1	1	0	31392	11402	19990	0	0	0	132
21-27141487-C-T	3.18593E-05	0	5.004E-05	1	0	1	31388	11404	19984	0	0	0	271
21-27141527-C-T	0.000223029	8.76578E-05	0.00030033	7	1	6	31386	11408	19978	0	0	0	386
21-27141557-C-T	9.55475E-05	0	0.000150105	3	0	3	31398	11412	19986	0	0	0	395
21-27141591-G-T	0.000127397	0.000175254	0.00010007	4	2	2	31398	11412	19986	0	0	0	444
21-27141592-C-T	0.000127453	0.000175285	0.00010013	4	2	2	31384	11410	19974	0	0	0	118
21-27141607-C-T	0.000127413	0	0.00020014	4	0	4	31394	11408	19986	0	0	0	128
21-27141610-T-C	3.18471E-05	0	5.004E-05	1	0	1	31400	11416	19984	0	0	0	20
21-27141619-A-G	0.01195181	0.032696353	0.00010016	375	373	2	31376	11408	19968	9	9	0	189
21-27141655-T-A	9.55353E-05	0	0.00015006	3	0	3	31402	11410	19992	0	0	0	442
21-27141671-T-A	6.36983E-05	8.76271E-05	5.0035E-05	2	1	1	31398	11412	19986	0	0	0	331
21-27141680-T-C	3.18492E-05	0	5.003E-05	1	0	1	31398	11410	19988	0	0	0	82
21-27141689-T-A	6.37146E-05	0	0.00010006	2	0	2	31390	11402	19988	0	0	0	44
21-27141721-T-C	3.1841E-05	0	5.001E-05	1	0	1	31406	11410	19996	0	0	0	360
21-27141751-T-A	3.18512E-05	8.76578E-05	0	1	1	0	31396	11408	19988	0	0	0	396
21-27141757-A-G	6.36902E-05	0.000175254	0	2	2	0	31402	11412	19990	0	0	0	288
21-27141799-C-T	3.18532E-05	0	5.0035E-05	1	0	1	31394	11408	19986	0	0	0	477
21-27141803-C-G	6.36983E-05	0	0.00010007	2	0	2	31398	11412	19986	0	0	0	355
21-27141809-G-A	0.023537667	0.064291996	0.00035028	738	731	7	31354	11370	19984	30	30	0	375
21-27141849-T-C	9.55597E-05	0.000262927	0	3	3	0	31394	11410	19984	0	0	0	366
21-27141875-A-G	3.18512E-05	8.76271E-05	0	1	1	0	31396	11412	19984	0	0	0	262
21-27141887-T-C	3.18796E-05	8.77193E-05	0	1	1	0	31368	11400	19968	0	0	0	139
21-27141889-T-G	3.18613E-05	8.76885E-05	0	1	1	0	31386	11404	19982	0	0	0	304
21-27141916-T-C	0.00044603	0.001227209	0	14	14	0	31388	11408	19980	0	0	0	164
21-27141953-G-A	3.18512E-05	0	5.0045E-05	1	0	1	31396	11414	19982	0	0	0	367
21-27141972-C-T	9.55536E-05	0.000262835	0	3	3	0	31396	11414	19982	0	0	0	59
21-27141975-G-GA	3.18573E-05	0	5.00501E-05	1	0	1	31390	11410	19980	0	0	0	107
21-27141992-G-C	3.18492E-05	8.76117E-05	0	1	1	0	31398	11414	19984	0	0	0	2
21-27142010-G-GT	3.18634E-05	0	5.0045E-05	1	0	1	31384	11402	19982	0	0	0	30
21-27142012-TTCATC-T	0.000159226	0	0.000250125	5	0	5	31402	11412	19990	0	0	0	174
21-27142038-G-A	6.37105E-05	0.000175254	0	2	2	0	31392	11412	19980	0	0	0	35
21-27142047-G-A	0.000223214	0.000614574	0	7	7	0	31360	11390	19970	0	0	0	338
21-27142061-TAATA-T	9.55657E-05	0	0.00015012	3	0	3	31392	11408	19984	0	0	0	485
21-27142082-GTATCAGGT-G	3.18613E-05	8.77039E-05	0	1	1	0	31386	11402	19984	0	0	0	339
21-27142086-C-G	9.56023E-05	0.000262881	0	3	3	0	31380	11412	19968	0	0	0	2
21-27142089-G-T	0.000318674	0.000788782	5.00751E-05	10	9	1	31380	11410	19970	0	0	0	436
21-27142098-A-C	3.18532E-05	8.76732E-05	0	1	1	0	31394	11406	19988	0	0	0	450
21-27142098-A-G	6.37064E-05	0	0.00010006	2	0	2	31394	11406	19988	0	0	0	190
21-27142099-T-C	0.000191144	0	0.00030021	6	0	6	31390	11404	19986	0	0	0	345
21-27142105-C-G	6.37308E-05	0.000175377	0	2	2	0	31382	11404	19978	0	0	0	172
21-27142131-T-G	3.18471E-05	8.76424E-05	0	1	1	0	31400	11410	19990	0	0	0	180
21-27142134-C-A	3.18552E-05	8.76732E-05	0	1	1	0	31392	11406	19986	0	0	0	39
21-27142141-G-A	0.000828184	0.000350447	0.001101101	26	4	22	31394	11414	19980	0	0	0	425
21-27142148-T-C	3.18512E-05	8.76117E-05	0	1	1	0	31396	11414	19982	0	0	0	318
21-27142150-A-G	3.18471E-05	0	5.0035E-05	1	0	1	31400	11414	19986	0	0	0	343
21-27142155-G-A	3.18552E-05	0	5.00501E-05	1	0	1	31392	11412	19980	0	0	0	371
21-27142174-T-A	3.18471E-05	0	5.0025E-05	1	0	1	31400	11410	19990	0	0	0	446
21-27142183-A-T	3.18471E-05	0	5.0035E-05	1	0	1	31400	11414	19986	0	0	0	208
21-27142236-A-G	0.000127453	0.000350693	0	4	4	0	31384	11406	19978	0	0	0	363
21-27142246-A-G	6.37064E-05	0.000175316	0	2	2	0	31394	11408	19986	0	0	0	317
21-27142258-G-A	0.000350631	0.000964574	0	11	11	0	31372	11404	19968	0	0	0	156
21-27142278-A-G	3.18654E-05	0	5.00601E-05	1	0	1	31382	11406	19976	0	0	0	421
21-27142302-A-G	3.18593E-05	0	5.004E-05	1	0	1	31388	11404	19984	0	0	0	268
21-27142305-T-A	3.18654E-05	0	5.00501E-05	1	0	1	31382	11402	19980	0	0	0	427
21-27142325-T-C	6.37389E-05	0.000175254	0	2	2	0	31378	11412	19966	0	0	0	149
21-27142328-A-T	3.18654E-05	8.76117E-05	0	1	1	0	31382	11414	19968	0	0	0	74
21-27142364-AGGTTTGTTTT-A	3.18492E-05	8.76117E-05	0	1	1	0	31398	11414	19984	0	0	0	230
21-27142390-C-T	3.18796E-05	8.76271E-05	0	1	1	0	31368	11412	19956	0	0	0	3
21-27142405-T-G	3.18532E-05	0	5.00501E-05	1	0	1	31394	11414	19980	0	0	0	75
21-27142407-C-T	0.000605713	0.00166579	0	19	19	0	31368	11406	19962	0	0	0	333
21-27142411-G-A	3.18715E-05	0	5.00902E-05	1	0	1	31376	11412	19964	0	0	0	500
21-27142428-T-C	6.3743E-05	0	0.00010015	2	0	2	31376	11406	19970	0	0	0	402
21-27142440-TA-T	3.18634E-05	8.76732E-05	0	1	1	0	31384	11406	19978	0	0	0	78
21-27142443-A-T	3.18695E-05	8.76424E-05	0	1	1	0	31378	11410	19968	0	0	0	212
21-27142446-C-T	6.37714E-05	0	0.00010019	2	0	2	31362	11400	19962	0	0	0	44
21-27142486-A-G	3.18573E-05	8.75964E-05	0	1	1	0	31390	11416	19974	0	0	0	49
21-27142524-A-G	3.18898E-05	0	5.01253E-05	1	0	1	31358	11408	19950	0	0	0	180
21-27142578-C-A	3.18796E-05	0	5.01002E-05	1	0	1	31368	11408	19960	0	0	0	497
21-27142632-C-T	3.18776E-05	0	5.00701E-05	1	0	1	31370	11398	19972	0	0	0	492
21-27142633-T-C	3.18695E-05	8.76578E-05	0	1	1	0	31378	11408	19970	0	0	0	117
21-27142668-T-A	3.18715E-05	0	5.00902E-05	1	0	1	31376	11412	19964	0	0	0	306
21-27142668-T-C	3.18715E-05	8.76271E-05	0	1	1	0	31376	11412	19964	0	0	0	398
21-27142682-T-G	0.011949525	0.032690622	0.00010014	375	373	2	31382	11410	19972	9	9	0	400
21-27142684-T-C	3.18695E-05	8.76424E-05	0	1	1	0	31378	11410	19968	0	0	0	263
21-27142701-TAAAC-T	6.37511E-05	0	0.00010018	2	0	2	31372	11408	19964	0	0	0	458
21-27142726-TTAAC-T	0.000127478	0.000175285	0.00010016	4	2	2	31378	11410	19968	0	0	0	181
21-27142741-A-G	3.18634E-05	8.76271E-05	0	1	1	0	31384	11412	19972	0	0	0	9
21-27142745-A-G	3.18613E-05	0	5.00651E-05	1	0	1	31386	11412	19974	0	0	0	117
21-27142764-C-T	6.37592E-05	0.000175316	0	2	2	0	31368	11408	19960	0	0	0	363
21-27142765-G-A	0.000159479	0	0.000250551	5	0	5	31352	11396	19956	0	0	0	327
21-27142770-C-T	0.004111161	0.000700894	0.00606091	129	8	121	31378	11414	19964	1	0	1	100
21-27142780-A-G	0.00041425	0.000175316	0.000550716	13	2	11	31382	11408	19974	0	0	0	194
21-27142793-T-A	3.19142E-05	0	5.01907E-05	1	0	1	31334	11410	19924	0	0	0	152
21-27142794-C-G	3.19285E-05	8.76578E-05	0	1	1	0	31320	11408	19912	0	0	0	226
21-27142807-TTC-T	0.026894398	0.005256702	0.039262821	844	60	784	31382	11414	19968	14	0	14	6
21-27142814-T-G	3.18573E-05	8.76424E-05	0	1	1	0	31390	11410	19980	0	0	0	492
21-27142837-C-T	9.56267E-05	0.000175285	5.00952E-05	3	2	1	31372	11410	19962	0	0	0	323
21-27142838-G-A	3.18695E-05	8.76424E-05	0	1	1	0	31378	11410	19968	0	0	0	206
21-27142838-G-T	3.18695E-05	8.76424E-05	0	1	1	0	31378	11410	19968	0	0	0	222
21-27142848-A-C	0.000127445	0.000350508	0	4	4	0	31386	11412	19974	0	0	0	298
21-27142861-A-G	3.18573E-05	0	5.00601E-05	1	0	1	31390	11414	19976	0	0	0	70
21-27142900-C-G	6.37267E-05	0	0.00010015	2	0	2	31384	11414	19970	0	0	0	484
21-27142905-A-G	3.18451E-05	0	5.0035E-05	1	0	1	31402	11416	19986	0	0	0	82
21-27142914-C-T	0.003983175	0.010865755	5.00751E-05	125	124	1	31382	11412	19970	0	0	0	305
21-27142915-ACCTTCT-A	3.18654E-05	8.76578E-05	0	1	1	0	31382	11408	19974	0	0	0	350
21-27142930-G-C	0.001307065	0.003509388	5.00751E-05	41	40	1	31368	11398	19970	0	0	0	374
21-27142971-TCAG-T	3.18654E-05	8.76578E-05	0	1	1	0	31382	11408	19974	0	0	0	237
21-27142996-G-C	3.18918E-05	0	5.01253E-05	1	0	1	31356	11406	19950	0	0	0	34
21-27143006-G-C	3.19244E-05	8.80127E-05	0	1	1	0	31324	11362	19962	0	0	0	336
21-27143010-G-T	3.18735E-05	0	5.00801E-05	1	0	1	31374	11406	19968	0	0	0	478
21-27143022-A-G	0.000223058	0.000613497	0	7	7	0	31382	11410	19972	0	0	0	432
21-27143026-T-C	3.18756E-05	8.76732E-05	0	1	1	0	31372	11406	19966	0	0	0	393
21-27143036-A-T	3.18674E-05	8.76578E-05	0	1	1	0	31380	11408	19972	0	0	0	134
21-27143037-G-A	3.18735E-05	0	5.00801E-05	1	0	1	31374	11406	19968	0	0	0	84
21-27143044-T-C	6.37592E-05	0.000175469	0	2	2	0	31368	11398	19970	0	0	0	308
21-27143046-G-A	3.18756E-05	0	5.00851E-05	1	0	1	31372	11406	19966	0	0	0	248
21-27143092-G-A	3.18674E-05	0	5.00651E-05	1	0	1	31380	11406	19974	0	0	0	133
21-27143107-G-A	3.18634E-05	8.76732E-05	0	1	1	0	31384	11406	19978	0	0	0	109
21-27143118-C-T	6.37511E-05	8.76271E-05	5.01002E-05	2	1	1	31372	11412	19960	0	0	0	261
21-27143146-T-C	0.0002231	0	0.000350596	7	0	7	31376	11410	19966	0	0	0	389
21-27143162-T-A	1	1	1	31390	11410	19980	31390	11410	19980	15695	5705	9990	52
21-27143166-T-C	9.56206E-05	0.000263019	0	3	3	0	31374	11406	19968	0	0	0	209
21-27143172-CAATT-C	6.37389E-05	0.000175316	0	2	2	0	31378	11408	19970	0	0	0	169
21-27143181-C-CTT	3.18715E-05	0	5.00651E-05	1	0	1	31376	11402	19974	0	0	0	4
21-27143181-C-T	0.033082611	0.089896509	0.000650846	1038	1025	13	31376	11402	19974	55	55	0	358
21-27143182-A-T	3.18674E-05	0	5.00751E-05	1	0	1	31380	11410	19970	0	0	0	154
21-27143209-TATCTG-T	6.37146E-05	0.000175254	0	2	2	0	31390	11412	19978	0	0	0	453
21-27143215-A-G	3.18735E-05	8.77039E-05	0	1	1	0	31374	11402	19972	0	0	0	267
21-27143228-T-C	3.18695E-05	0	5.00801E-05	1	0	1	31378	11410	19968	0	0	0	96
21-27143246-T-C	0.001561703	0.000438212	0.002203746	49	5	44	31376	11410	19966	0	0	0	49
21-27143274-T-G	3.18735E-05	0	5.00902E-05	1	0	1	31374	11410	19964	0	0	0	309
21-27143279-G-A	0.033156922	0.090103527	0.000651042	1040	1027	13	31366	11398	19968	55	55	0	398
21-27143282-C-T	0.003315692	0.009030335	5.01002E-05	104	103	1	31366	11406	19960	0	0	0	92
21-27143316-T-C	0.000382531	8.77039E-05	0.000550881	12	1	11	31370	11402	19968	0	0	0	292
21-27143323-A-G	6.37227E-05	0	0.00010011	2	0	2	31386	11408	19978	0	0	0	226
21-27143349-C-G	6.37592E-05	0	0.00010019	2	0	2	31368	11406	19962	0	0	0	500
21-27143401-C-T	3.19142E-05	0	5.01505E-05	1	0	1	31334	11394	19940	0	0	0	104
21-27143402-G-T	6.38407E-05	0.000175531	0	2	2	0	31328	11394	19934	0	0	0	79
21-27143403-G-T	3.19163E-05	8.77501E-05	0	1	1	0	31332	11396	19936	0	0	0	297
21-27143405-C-A	9.57488E-05	0	0.000150466	3	0	3	31332	11394	19938	0	0	0	160
21-27143417-C-A	3.19244E-05	8.77963E-05	0	1	1	0	31324	11390	19934	0	0	0	460
21-27143435-A-G	0.000159683	0.00043852	0	5	5	0	31312	11402	19910	0	0	0	138
21-27143436-A-G	3.19224E-05	8.76885E-05	0	1	1	0	31326	11404	19922	0	0	0	471
21-27143438-A-T	9.57426E-05	0.000175377	5.01756E-05	3	2	1	31334	11404	19930	0	0	0	104
21-27143444-A-G	3.19081E-05	0	5.01605E-05	1	0	1	31340	11404	19936	0	0	0	249
21-27143449-G-C	0.000894569	0.002281502	0.000100482	28	26	2	31300	11396	19904	1	1	0	270
21-27143454-C-T	0.000159653	0.000438827	0	5	5	0	31318	11394	19924	0	0	0	288
21-27143490-G-T	3.19285E-05	8.77347E-05	0	1	1	0	31320	11398	19922	0	0	0	182
21-27143520-CAT-C	0.00060668	0.001667544	0	19	19	0	31318	11394	19924	0	0	0	93
21-27143548-A-G	0.033126955	0.089896509	0.000652218	1038	1025	13	31334	11402	19932	55	55	0	98
21-27143567-ATGTG-A	0.000191473	8.76732E-05	0.000250878	6	1	5	31336	11406	19930	0	0	0	438
21-27143591-A-G	3.19061E-05	8.76117E-05	0	1	1	0	31342	11414	19928	0	0	0	45
21-27143615-GA-G	3.21192E-05	8.79198E-05	0	1	1	0	31134	11374	19760	0	0	0	255
21-27143623-A-T	3.23729E-05	8.82301E-05	0	1	1	0	30890	11334	19556	0	0	0	310
21-27143624-T-C	6.46914E-05	8.80747E-05	5.11195E-05	2	1	1	30916	11354	19562	0	0	0	263
21-27143632-T-C	9.86258E-05	8.87626E-05	0.000104428	3	1	2	30418	11266	19152	0	0	0	224
21-27143652-TG-T	4.92174E-05	0	9.36154E-05	1	0	1	20318	9636	10682	0	0	0	23
21-27143654-G-GT	0.000553674	0.000801568	0.000410762	17	9	8	30704	11228	19476	0	0	0	166
21-27143654-GT-G	0.549798072	0.351086569	0.664356131	16881	3942	12939	30704	11228	19476	5048	743	4305	44
21-27143663-T-A	0.023518435	0.063700441	0.000405433	731	723	8	31082	11350	19732	26	26	0	425
21-27143688-CCTTTAG-C	3.21254E-05	0	5.05868E-05	1	0	1	31128	11360	19768	0	0	0	26
21-27143689-CT-C	0.009059368	0.024731561	5.05919E-05	282	281	1	31128	11362	19766	2	2	0	423
21-27143697-A-G	3.21543E-05	8.80747E-05	0	1	1	0	31100	11354	19746	0	0	0	87
21-27143709-T-G	3.20307E-05	8.78117E-05	0	1	1	0	31220	11388	19832	0	0	0	335
21-27143714-C-T	3.21275E-05	8.79662E-05	0	1	1	0	31126	11368	19758	0	0	0	478
21-27143751-A-G	3.20041E-05	0	5.03626E-05	1	0	1	31246	11390	19856	0	0	0	386
21-27143754-CT-C	0.00051884	0.001414677	0	16	16	0	30838	11310	19528	0	0	0	294
21-27143780-A-G	0.000512328	0.000351	0.000605022	16	4	12	31230	11396	19834	0	0	0	151
21-27143789-A-G	3.19836E-05	8.77963E-05	0	1	1	0	31266	11390	19876	0	0	0	206
21-27143795-A-G	0.000127959	0	0.000201369	4	0	4	31260	11396	19864	0	0	0	74
21-27143821-C-G	0.003044481	0.001053926	0.004188112	95	12	83	31204	11386	19818	0	0	0	37
21-27143835-C-T	0.011782032	0.03198594	0.000201471	368	364	4	31234	11380	19854	8	8	0	428
21-27143849-A-T	3.19918E-05	8.77809E-05	0	1	1	0	31258	11392	19866	0	0	0	383
21-27143864-G-T	3.21895E-05	0	5.07408E-05	1	0	1	31066	11358	19708	0	0	0	278
21-27143871-T-G	0.000895541	0.00245916	0	28	28	0	31266	11386	19880	0	0	0	400
21-27143874-G-A	3.21254E-05	8.80282E-05	0	1	1	0	31128	11360	19768	0	0	0	342
21-27143881-G-A	3.2039E-05	0	5.04083E-05	1	0	1	31212	11374	19838	0	0	0	186
21-27143896-G-GT	0.00169763	0.004567814	5.04134E-05	53	52	1	31220	11384	19836	0	0	0	2
21-27143896-GT-G	3.20307E-05	8.78426E-05	0	1	1	0	31220	11384	19836	0	0	0	205
21-27143899-T-G	3.19591E-05	0	5.02715E-05	1	0	1	31290	11398	19892	0	0	0	370
21-27143901-T-C	3.19468E-05	0	5.02361E-05	1	0	1	31302	11396	19906	0	0	0	313
21-27143916-TATAAC-T	3.1957E-05	8.77501E-05	0	1	1	0	31292	11396	19896	0	0	0	141
21-27143933-AAAT-A	3.19346E-05	0	5.01756E-05	1	0	1	31314	11384	19930	0	0	0	251
21-27143939-AATTT-A	3.19428E-05	8.78735E-05	0	1	1	0	31306	11380	19926	0	0	0	45
21-27143940-A-G	0.005303176	0.014152602	0.000250928	166	161	5	31302	11376	19926	2	2	0	232
21-27143944-A-T	3.1955E-05	8.79198E-05	0	1	1	0	31294	11374	19920	0	0	0	296
21-27143949-A-G	0.007188958	0.01934236	0.000250954	225	220	5	31298	11374	19924	3	3	0	398
21-27143949-ATTC-A	0.000319509	0.000879198	0	10	10	0	31298	11374	19924	0	0	0	180
21-27143951-TCTTTG-T	0.012931034	0.035100035	0.000250954	405	400	5	31320	11396	19924	7	7	0	253
21-27143959-T-C	0.0001595	0	0.000250727	5	0	5	31348	11406	19942	0	0	0	288
21-27143960-T-C	3.19061E-05	0	5.01505E-05	1	0	1	31342	11402	19940	0	0	0	178
21-27143975-A-T	6.3861E-05	8.76885E-05	5.02159E-05	2	1	1	31318	11404	19914	0	0	0	242
21-27144002-A-G	0.002649556	0.007276872	0	83	83	0	31326	11406	19920	0	0	0	273
21-27144026-GTCA-G	6.38814E-05	0	0.000100452	2	0	2	31308	11398	19910	0	0	0	204
21-27144053-G-A	3.19122E-05	8.76885E-05	0	1	1	0	31336	11404	19932	0	0	0	268
21-27144055-A-AT	6.38081E-05	0	0.000100311	2	0	2	31344	11406	19938	0	0	0	307
21-27144076-A-G	3.19101E-05	8.77039E-05	0	1	1	0	31338	11402	19936	0	0	0	424
21-27144082-G-C	3.20082E-05	8.77655E-05	0	1	1	0	31242	11394	19848	0	0	0	296
21-27144096-T-G	6.38081E-05	0	0.000100271	2	0	2	31344	11398	19946	0	0	0	330
21-27144122-A-G	6.37714E-05	0.000175377	0	2	2	0	31362	11404	19958	0	0	0	220
21-27144146-C-T	0.008012514	0.001404248	0.011790086	251	16	235	31326	11394	19932	2	0	2	266
21-27144160-T-C	3.18959E-05	0	5.01153E-05	1	0	1	31352	11398	19954	0	0	0	210
21-27144254-C-T	3.19183E-05	8.76732E-05	0	1	1	0	31330	11406	19924	0	0	0	92
21-27144281-T-A	3.18654E-05	8.76117E-05	0	1	1	0	31382	11414	19968	0	0	0	400
21-27144289-C-T	3.18918E-05	0	5.01253E-05	1	0	1	31356	11406	19950	0	0	0	243
21-27144315-A-G	0.024276794	0.00832603	0.033386725	762	95	667	31388	11410	19978	12	0	12	135
21-27144334-A-T	6.37186E-05	0	0.00010012	2	0	2	31388	11412	19976	0	0	0	236
21-27144344-A-G	3.18634E-05	8.76578E-05	0	1	1	0	31384	11408	19976	0	0	0	346
21-27144369-A-G	0.000477829	0.000350447	0.000550606	15	4	11	31392	11414	19978	0	0	0	319
21-27144430-A-C	3.18715E-05	0	5.00851E-05	1	0	1	31376	11410	19966	0	0	0	300
21-27144448-T-C	0.000478164	0	0.000751352	15	0	15	31370	11406	19964	0	0	0	260
21-27144469-AACTT-A	6.37511E-05	8.76732E-05	5.00851E-05	2	1	1	31372	11406	19966	0	0	0	104
21-27144471-CTT-C	0.000510237	8.76732E-05	0.000751804	16	1	15	31358	11406	19952	0	0	0	359
21-27144506-T-C	3.18837E-05	8.76578E-05	0	1	1	0	31364	11408	19956	0	0	0	116
21-27144516-A-G	3.18776E-05	8.76271E-05	0	1	1	0	31370	11412	19958	0	0	0	25
21-27144530-G-T	3.19E-05	8.76732E-05	0	1	1	0	31348	11406	19942	0	0	0	422
21-27144541-C-A	3.1904E-05	0	5.01505E-05	1	0	1	31344	11404	19940	0	0	0	491
21-27144541-C-T	6.38081E-05	0.000175377	0	2	2	0	31344	11404	19940	0	0	0	189
21-27144543-A-G	0.000127445	0.000350631	0	4	4	0	31386	11408	19978	0	0	0	495
21-27144548-C-A	0.000510172	8.77193E-05	0.000751428	16	1	15	31362	11400	19962	0	0	0	160
21-27144554-C-T	6.37471E-05	0.000175346	0	2	2	0	31374	11406	19968	0	0	0	429
21-27144558-TG-T	6.37389E-05	0.000175408	0	2	2	0	31378	11402	19976	0	0	0	50
21-27144582-A-G	3.18634E-05	0	5.00601E-05	1	0	1	31384	11408	19976	0	0	0	364
21-27144597-T-G	3.18776E-05	8.77039E-05	0	1	1	0	31370	11402	19968	0	0	0	418
21-27144597-TTAAA-T	0.000159388	0.000350816	5.00801E-05	5	4	1	31370	11402	19968	0	0	0	496
21-27144605-C-T	6.37959E-05	0.000175377	0	2	2	0	31350	11404	19946	0	0	0	481
21-27144611-C-T	6.38081E-05	0.0001755	0	2	2	0	31344	11396	19948	0	0	0	233
21-27144612-G-A	3.19203E-05	8.77501E-05	0	1	1	0	31328	11396	19932	0	0	0	288
21-27144612-G-T	3.19203E-05	0	5.01706E-05	1	0	1	31328	11396	19932	0	0	0	391
21-27144613-A-T	3.18939E-05	0	5.01052E-05	1	0	1	31354	11396	19958	0	0	0	349
21-27144620-T-C	3.18695E-05	0	5.00701E-05	1	0	1	31378	11406	19972	0	0	0	417
21-27144649-TTG-T	9.5584E-05	0.000262881	0	3	3	0	31386	11412	19974	0	0	0	83
21-27144660-A-T	3.19652E-05	0	5.02715E-05	1	0	1	31284	11392	19892	0	0	0	22
21-27144660-AT-A	0.000447513	0.000702247	0.000301629	14	8	6	31284	11392	19892	0	0	0	219
21-27144660-ATTT-A	3.19652E-05	0	5.02715E-05	1	0	1	31284	11392	19892	0	0	0	250
21-27144662-T-G	6.38733E-05	0	0.000100371	2	0	2	31312	11386	19926	0	0	0	31
21-27144668-T-C	3.18695E-05	8.76578E-05	0	1	1	0	31378	11408	19970	0	0	0	386
21-27144683-AAC-A	3.18634E-05	8.76424E-05	0	1	1	0	31384	11410	19974	0	0	0	138
21-27144705-G-A	6.39304E-05	0	0.000100503	2	0	2	31284	11384	19900	0	0	0	39
21-27144717-T-C	3.18674E-05	8.76578E-05	0	1	1	0	31380	11408	19972	0	0	0	174
21-27144717-TTG-T	3.18674E-05	0	5.00701E-05	1	0	1	31380	11408	19972	0	0	0	455
21-27144744-A-G	9.56206E-05	0	0.00015024	3	0	3	31374	11406	19968	0	0	0	303
21-27144757-A-G	3.18735E-05	0	5.00601E-05	1	0	1	31374	11398	19976	0	0	0	88
21-27144759-C-G	3.19203E-05	0	5.01303E-05	1	0	1	31328	11380	19948	0	0	0	368
21-27144761-A-G	6.37349E-05	0.000175377	0	2	2	0	31380	11404	19976	0	0	0	471
21-27144787-TAA-T	0.000414303	0.000175316	0.000550826	13	2	11	31378	11408	19970	0	0	0	392
21-27144792-G-GT	0.000159785	0.000351432	5.0226E-05	5	4	1	31292	11382	19910	0	0	0	89
21-27144798-T-C	3.18674E-05	0	5.00751E-05	1	0	1	31380	11410	19970	0	0	0	41
21-27144857-C-T	3.18674E-05	0	5.00651E-05	1	0	1	31380	11406	19974	0	0	0	151
21-27144869-C-T	3.18451E-05	8.75964E-05	0	1	1	0	31402	11416	19986	0	0	0	143
21-27144870-G-A	3.18634E-05	0	5.00551E-05	1	0	1	31384	11406	19978	0	0	0	214
21-27144886-C-T	0.000159398	0.000263019	0.00010019	5	3	2	31368	11406	19962	0	0	0	234
21-27144887-G-A	6.37511E-05	0.000175316	0	2	2	0	31372	11408	19964	0	0	0	7
21-27144901-C-T	6.37471E-05	0	0.00010016	2	0	2	31374	11406	19968	0	0	0	111
21-27144904-A-C	9.55657E-05	0.000262881	0	3	3	0	31392	11412	19980	0	0	0	161
21-27144950-G-A	0.005321522	0.014198072	0.00025035	167	162	5	31382	11410	19972	2	2	0	336
21-27144975-A-G	3.18512E-05	0	5.0035E-05	1	0	1	31396	11410	19986	0	0	0	388
21-27144998-A-G	0.000159215	8.76271E-05	0.00020008	5	1	4	31404	11412	19992	0	0	0	165
21-27145025-A-G	3.18471E-05	0	5.0035E-05	1	0	1	31400	11414	19986	0	0	0	307
21-27145056-A-G	0.000159226	0.000175223	0.00015009	5	2	3	31402	11414	19988	0	0	0	95
21-27145064-C-T	3.18613E-05	0	5.00651E-05	1	0	1	31386	11412	19974	0	0	0	289
21-27145077-C-CT	0.002308643	0.001152482	0.00297833	71	13	58	30754	11280	19474	1	0	1	236
21-27145087-A-G	3.25415E-05	8.85897E-05	0	1	1	0	30730	11288	19442	0	0	0	460
21-27145118-T-C	3.18552E-05	0	5.0045E-05	1	0	1	31392	11410	19982	0	0	0	246
21-27145131-C-T	9.56389E-05	0.000262927	0	3	3	0	31368	11410	19958	0	0	0	282
21-27145174-A-G	0.081713922	0.102438169	0.069891935	2565	1168	1397	31390	11402	19988	106	63	43	73
21-27145200-G-A	3.1839E-05	8.76271E-05	0	1	1	0	31408	11412	19996	0	0	0	169
21-27145205-G-C	0.000477737	0	0.00075045	15	0	15	31398	11410	19988	0	0	0	152
21-27145210-G-A	3.18431E-05	0	5.002E-05	1	0	1	31404	11412	19992	0	0	0	492
21-27145246-A-G	3.1837E-05	0	5.001E-05	1	0	1	31410	11414	19996	0	0	0	84
21-27145287-G-T	3.18431E-05	8.76271E-05	0	1	1	0	31404	11412	19992	0	0	0	394
21-27145291-C-A	3.18492E-05	0	5.004E-05	1	0	1	31398	11414	19984	0	0	0	428
21-27145303-A-C	3.1837E-05	8.76117E-05	0	1	1	0	31410	11414	19996	0	0	0	256
21-27145306-CA-C	0.00025481	8.76424E-05	0.000350245	8	1	7	31396	11410	19986	0	0	0	221
21-27145307-A-C	6.36821E-05	0	0.00010003	2	0	2	31406	11412	19994	0	0	0	167
21-27145320-C-G	3.18451E-05	8.76424E-05	0	1	1	0	31402	11410	19992	0	0	0	334
21-27145324-A-AC	3.18471E-05	0	5.002E-05	1	0	1	31400	11408	19992	0	0	0	302
21-27145325-C-T	3.18451E-05	0	5.0025E-05	1	0	1	31402	11412	19990	0	0	0	431
21-27145335-G-A	3.18451E-05	0	5.002E-05	1	0	1	31402	11410	19992	0	0	0	246
21-27145337-A-G	3.18451E-05	0	5.002E-05	1	0	1	31402	11410	19992	0	0	0	230
21-27145338-T-A	3.18492E-05	0	5.0025E-05	1	0	1	31398	11408	19990	0	0	0	490
21-27145365-T-G	6.36902E-05	0.000175316	0	2	2	0	31402	11408	19994	0	0	0	256
21-27145369-G-T	3.18552E-05	0	5.0035E-05	1	0	1	31392	11406	19986	0	0	0	298
21-27145374-C-T	0.002420382	0.006486676	0.00010004	76	74	2	31400	11408	19992	1	1	0	84
21-27145375-A-G	3.1837E-05	8.75964E-05	0	1	1	0	31410	11416	19994	0	0	0	447
21-27145378-T-G	6.3674E-05	0.000175254	0	2	2	0	31410	11412	19998	0	0	0	7
21-27145384-G-A	3.18471E-05	8.76424E-05	0	1	1	0	31400	11410	19990	0	0	0	451
21-27145387-T-G	6.36862E-05	0	0.00010004	2	0	2	31404	11412	19992	0	0	0	479
21-27145428-A-G	0.000127364	0.000350631	0	4	4	0	31406	11408	19998	0	0	0	319
21-27145454-T-C	0.023309133	0.06365071	0.00030003	732	726	6	31404	11406	19998	28	28	0	327
21-27145467-C-T	0.023738211	0.064725487	0.000350315	745	738	7	31384	11402	19982	30	30	0	72
21-27145468-G-A	0.000860311	0.000438673	0.001100771	27	5	22	31384	11398	19986	0	0	0	239
21-27145468-G-T	3.18634E-05	8.77347E-05	0	1	1	0	31384	11398	19986	0	0	0	398
21-27145476-G-A	3.18654E-05	8.77193E-05	0	1	1	0	31382	11400	19982	0	0	0	466
21-27145479-C-A	3.18695E-05	0	5.00601E-05	1	0	1	31378	11402	19976	0	0	0	195
21-27145482-C-CT	6.37105E-05	0.000175316	0	2	2	0	31392	11408	19984	0	0	0	479
21-27145502-C-T	0.000127502	0.000262973	5.00902E-05	4	3	1	31372	11408	19964	0	0	0	210
21-27145517-G-A	0.01169833	0.031830937	0.000200321	367	363	4	31372	11404	19968	8	8	0	415
21-27145549-G-A	6.36983E-05	0.000175223	0	2	2	0	31398	11414	19984	0	0	0	254
21-27145565-T-G	0.000222902	0.000262881	0.00020008	7	3	4	31404	11412	19992	0	0	0	71
21-27145570-A-G	3.18573E-05	0	5.0035E-05	1	0	1	31390	11404	19986	0	0	0	260
21-27145588-G-A	3.18695E-05	0	5.00701E-05	1	0	1	31378	11406	19972	0	0	0	32
21-27145602-AAAAC-A	3.18471E-05	8.76732E-05	0	1	1	0	31400	11406	19994	0	0	0	222
21-27145613-G-A	3.18715E-05	8.77039E-05	0	1	1	0	31376	11402	19974	0	0	0	75
21-27145682-A-C	3.18674E-05	0	5.00551E-05	1	0	1	31380	11402	19978	0	0	0	46
21-27145682-A-G	3.18674E-05	8.77039E-05	0	1	1	0	31380	11402	19978	0	0	0	74
21-27145687-G-A	3.20164E-05	8.81213E-05	0	1	1	0	31234	11348	19886	0	0	0	81
21-27145689-A-G	6.38203E-05	0.000176118	0	2	2	0	31338	11356	19982	0	0	0	84
21-27145702-G-A	0.000353789	0.000178795	0.000452125	11	2	9	31092	11186	19906	0	0	0	101
21-27145707-G-A	3.3745E-05	9.11577E-05	0	1	1	0	29634	10970	18664	0	0	0	154
21-27145707-G-GT	0.03715327	0.099453054	0.000535791	1101	1091	10	29634	10970	18664	70	70	0	288
21-27145707-G-GTT	0.018762233	0.02461258	0.015323618	556	270	286	29634	10970	18664	23	20	3	455
21-27145707-G-GTTT	3.3745E-05	0	5.35791E-05	1	0	1	29634	10970	18664	0	0	0	421
21-27145707-GT-G	0.001046096	0.002825889	0	31	31	0	29634	10970	18664	0	0	0	388
21-27145710-T-G	3.18796E-05	8.77501E-05	0	1	1	0	31368	11396	19972	0	0	0	471
21-27145733-A-G	3.18695E-05	0	5.00651E-05	1	0	1	31378	11404	19974	0	0	0	340
21-27145744-A-T	3.18817E-05	8.77347E-05	0	1	1	0	31366	11398	19968	0	0	0	123
21-27145766-T-G	3.19081E-05	8.77809E-05	0	1	1	0	31340	11392	19948	0	0	0	492
21-27145788-C-T	0.009325498	0.025496747	0.000100311	292	290	2	31312	11374	19938	5	5	0	463
21-27145831-C-T	3.21481E-05	8.84956E-05	0	1	1	0	31106	11300	19806	0	0	0	115
21-27145846-ACT-A	0.099323591	0.089966614	0.104659319	3113	1024	2089	31342	11382	19960	180	87	93	480
21-27145875-C-T	0.011891857	0.03254957	0.00010016	373	371	2	31366	11398	19968	9	9	0	14
21-27145877-T-C	3.18492E-05	8.76117E-05	0	1	1	0	31398	11414	19984	0	0	0	23
21-27145887-G-A	0.00012747	0.000175346	0.00010013	4	2	2	31380	11406	19974	0	0	0	330
21-27145887-G-T	3.18674E-05	8.76732E-05	0	1	1	0	31380	11406	19974	0	0	0	456
21-27145908-A-T	6.37389E-05	0.000175654	0	2	2	0	31378	11386	19992	0	0	0	356
21-27145932-C-T	3.18654E-05	0	5.00501E-05	1	0	1	31382	11402	19980	0	0	0	310
21-27145940-C-T	3.18939E-05	0	5.01153E-05	1	0	1	31354	11400	19954	0	0	0	26
21-27145941-G-GC	9.58957E-05	0	0.000150723	3	0	3	31284	11380	19904	0	0	0	387
21-27145941-GC-G	3.19652E-05	8.78735E-05	0	1	1	0	31284	11380	19904	0	0	0	109
21-27145947-CT-C	3.18674E-05	8.77193E-05	0	1	1	0	31380	11400	19980	0	0	0	117
21-27145951-C-T	3.18756E-05	0	5.00601E-05	1	0	1	31372	11396	19976	0	0	0	439
21-27145958-A-C	0.000701173	0.001928809	0	22	22	0	31376	11406	19970	0	0	0	196
21-27145968-C-T	3.1904E-05	0	5.01505E-05	1	0	1	31344	11404	19940	0	0	0	50
21-27145980-C-T	6.37592E-05	0.000175439	0	2	2	0	31368	11400	19968	0	0	0	117
21-27145982-T-G	3.18634E-05	0	5.00501E-05	1	0	1	31384	11404	19980	0	0	0	335
21-27146042-A-T	6.45161E-05	0.000190694	0	1	1	0	15500	5244	10256	0	0	0	181
21-27146058-C-CA	1	1	1	31206	11394	19812	31206	11394	19812	15603	5697	9906	57
21-27146078-G-T	4.23334E-05	0	6.62427E-05	1	0	1	23622	8526	15096	0	0	0	353
21-27146096-C-CA	0.083333333	0.25	0	1	1	0	12	4	8	0	0	0	74
21-27146097-G-C	0.999499232	0.999733665	0.999357945	29939	11261	18678	29954	11264	18690	14962	5629	9333	491
21-27146097-G-GC	6.6769E-05	0.000177557	0	2	2	0	29954	11264	18690	0	0	0	156
21-27146098-C-CT	0.208333333	0	0.263157895	10	0	10	48	10	38	0	0	0	73
21-27146099-C-CT	0.00216763	0.002262443	0.002123142	3	1	2	1384	442	942	0	0	0	181
21-27146107-T-TA	0.020833333	0.055555556	0	1	1	0	48	18	30	0	0	0	73
21-27146108-C-A	0.99036474	0.974431818	0.99994661	29705	10976	18729	29994	11264	18730	14714	5350	9364	385
21-27146108-C-CA	0.00960192	0.025479403	5.33903E-05	288	287	1	29994	11264	18730	6	6	0	500
21-27146108-C-CG	3.334E-05	8.87784E-05	0	1	1	0	29994	11264	18730	0	0	0	22
21-27146128-C-T	6.47878E-05	8.81057E-05	5.12295E-05	2	1	1	30870	11350	19520	0	0	0	151
21-27146184-A-G	3.18431E-05	0	5.001E-05	1	0	1	31404	11408	19996	0	0	0	354
21-27146205-T-C	3.18695E-05	0	5.00551E-05	1	0	1	31378	11400	19978	0	0	0	247
21-27146207-T-C	9.55475E-05	0.000262927	0	3	3	0	31398	11410	19988	0	0	0	85
21-27146211-AACC-A	0.000222987	8.76885E-05	0.00030018	7	1	6	31392	11404	19988	0	0	0	266
21-27146212-A-G	6.37024E-05	8.76885E-05	5.002E-05	2	1	1	31396	11404	19992	0	0	0	314
21-27146214-C-T	3.18776E-05	8.77039E-05	0	1	1	0	31370	11402	19968	0	0	0	345
21-27146235-C-T	3.18817E-05	0	5.00902E-05	1	0	1	31366	11402	19964	0	0	0	340
21-27146236-G-A	6.37024E-05	0.000175316	0	2	2	0	31396	11408	19988	0	0	0	29
21-27146262-T-C	9.5584E-05	0.000262973	0	3	3	0	31386	11408	19978	0	0	0	499
21-27146308-G-A	3.19448E-05	8.78117E-05	0	1	1	0	31304	11388	19916	0	0	0	163
21-27146316-G-A	3.18857E-05	8.76424E-05	0	1	1	0	31362	11410	19952	0	0	0	438
21-27146335-T-C	0.000127698	0.000351247	0	4	4	0	31324	11388	19936	0	0	0	174
21-27146355-G-A	3.19366E-05	8.78889E-05	0	1	1	0	31312	11378	19934	0	0	0	351
21-27146363-C-T	3.20451E-05	8.84017E-05	0	1	1	0	31206	11312	19894	0	0	0	170
21-27146377-CTTG-C	3.21916E-05	0	5.04032E-05	1	0	1	31064	11224	19840	0	0	0	292
21-27146378-TTG-T	3.21709E-05	8.93975E-05	0	1	1	0	31084	11186	19898	0	0	0	291
21-27146380-G-GT	0.03791423	0.09080419	0.007379317	1167	1023	144	30780	11266	19514	53	52	1	385
21-27146382-T-G	0.011968766	0.032723434	0.000100604	374	372	2	31248	11368	19880	9	9	0	207
21-27146397-TCTCA-T	3.20842E-05	8.80902E-05	0	1	1	0	31168	11352	19816	0	0	0	51
21-27146398-C-G	3.2076E-05	0	5.04592E-05	1	0	1	31176	11358	19818	0	0	0	58
21-27146402-C-T	3.19346E-05	0	5.01857E-05	1	0	1	31314	11388	19926	0	0	0	119
21-27146404-C-T	0.120288	0.147265694	0.10485007	3759	1675	2084	31250	11374	19876	246	150	96	432
21-27146436-C-T	6.37999E-05	0.000175531	0	2	2	0	31348	11394	19954	0	0	0	385
21-27146437-G-A	6.37714E-05	8.76578E-05	5.01153E-05	2	1	1	31362	11408	19954	0	0	0	337
21-27146453-A-C	3.19E-05	0	5.01102E-05	1	0	1	31348	11392	19956	0	0	0	415
21-27146459-C-T	3.18878E-05	0	5.01153E-05	1	0	1	31360	11406	19954	0	0	0	407
21-27146460-G-A	0.000223371	0.000614251	0	7	7	0	31338	11396	19942	0	0	0	310
21-27146477-G-A	6.37633E-05	0.000175377	0	2	2	0	31366	11404	19962	0	0	0	459
21-27146519-A-G	0.997195487	0.992371098	0.999949935	31290	11317	19973	31378	11404	19974	15601	5615	9986	55
21-27146563-TG-T	3.18939E-05	0	5.01102E-05	1	0	1	31354	11398	19956	0	0	0	111
21-27146573-G-A	0.000223442	0.000614358	0	7	7	0	31328	11394	19934	0	0	0	161
21-27146583-C-T	3.18715E-05	8.77039E-05	0	1	1	0	31376	11402	19974	0	0	0	42
21-27146588-C-T	6.37349E-05	0.000175254	0	2	2	0	31380	11412	19968	0	0	0	11
21-27146595-C-T	3.18654E-05	8.76885E-05	0	1	1	0	31382	11404	19978	0	0	0	375
21-27146604-G-A	3.18593E-05	8.76578E-05	0	1	1	0	31388	11408	19980	0	0	0	309
21-27146627-C-T	6.55008E-05	0	0.000102564	2	0	2	30534	11034	19500	0	0	0	163
21-27146629-GCCT-G	3.30644E-05	9.16422E-05	0	1	1	0	30244	10912	19332	0	0	0	242
21-27146647-A-G	0.000121153	0.000401284	0	1	1	0	8254	2492	5762	0	0	0	275
21-27146653-G-A	0.1	0.25	0	2	2	0	20	8	12	0	0	0	126
21-27146656-G-A	0.03125	0	0.038461538	1	0	1	32	6	26	0	0	0	47
21-27146660-G-GC	1	1	1	31404	11412	19992	31404	11412	19992	15702	5706	9996	11
21-27146664-C-T	9.55962E-05	0.000263066	0	3	3	0	31382	11404	19978	0	0	0	19
21-27146674-C-G	3.18492E-05	8.76424E-05	0	1	1	0	31398	11410	19988	0	0	0	273
21-27146694-T-G	3.18471E-05	0	5.003E-05	1	0	1	31400	11412	19988	0	0	0	119
21-27146709-TGTTA-T	9.55414E-05	0.000263019	0	3	3	0	31400	11406	19994	0	0	0	71
21-27146738-T-G	6.36821E-05	0.000175285	0	2	2	0	31406	11410	19996	0	0	0	403
21-27146756-T-G	6.3674E-05	0.000175193	0	2	2	0	31410	11416	19994	0	0	0	390
21-27146774-T-G	9.55292E-05	0.000262973	0	3	3	0	31404	11408	19996	0	0	0	443
21-27146779-A-G	0.037774375	0.037206037	0.038099058	1184	424	760	31344	11396	19948	27	14	13	233
21-27146794-T-G	3.1837E-05	8.76117E-05	0	1	1	0	31410	11414	19996	0	0	0	67
21-27146812-T-C	0.016151641	0.005258545	0.022372372	507	60	447	31390	11410	19980	11	0	11	96
21-27146817-C-A	6.37308E-05	0.000175254	0	2	2	0	31382	11412	19970	0	0	0	466
21-27146823-A-G	6.36862E-05	0.000175254	0	2	2	0	31404	11412	19992	0	0	0	141
21-27146836-T-C	3.18715E-05	8.76732E-05	0	1	1	0	31376	11406	19970	0	0	0	459
21-27146837-G-A	6.38529E-05	0	0.000100361	2	0	2	31322	11394	19928	0	0	0	355
21-27146842-AAG-A	3.1839E-05	0	5.0005E-05	1	0	1	31408	11410	19998	0	0	0	433
21-27146857-GTGCTATATAAAGCTT-G	9.55597E-05	8.76732E-05	0.00010006	3	1	2	31394	11406	19988	0	0	0	393
21-27146863-T-G	3.1841E-05	0	5.0015E-05	1	0	1	31406	11412	19994	0	0	0	80
21-27146864-A-G	0.011748599	0.031983877	0.00020004	369	365	4	31408	11412	19996	8	8	0	178
21-27146870-C-T	3.18552E-05	0	5.0045E-05	1	0	1	31392	11410	19982	0	0	0	306
21-27146891-C-T	6.37186E-05	0.000175223	0	2	2	0	31388	11414	19974	0	0	0	470
21-27146921-A-C	3.18451E-05	8.76117E-05	0	1	1	0	31402	11414	19988	0	0	0	476
21-27146937-T-C	3.18431E-05	0	5.0015E-05	1	0	1	31404	11410	19994	0	0	0	135
21-27146959-T-C	9.55901E-05	0.000263112	0	3	3	0	31384	11402	19982	0	0	0	491
21-27146999-T-C	0.000414462	0.001052447	5.00902E-05	13	12	1	31366	11402	19964	0	0	0	191
